"","social_pm.date","social_pm.blog","social_pm.twitter","social_pm.news","social_pm.total"
"1","2016-01-01",134,114,64,312
"2","2016-01-02",195,133,71,399
"3","2016-01-03",396,477,146,1019
"4","2016-01-04",957,685,246,1888
"5","2016-01-05",629,228,94,951
"6","2016-01-06",398,139,85,622
"7","2016-01-07",349,121,52,522
"8","2016-01-08",293,141,47,481
"9","2016-01-09",121,117,21,259
"10","2016-01-10",153,107,25,285
"11","2016-01-11",237,143,52,432
"12","2016-01-12",192,113,68,373
"13","2016-01-13",199,62,33,294
"14","2016-01-14",183,58,46,287
"15","2016-01-15",190,87,100,377
"16","2016-01-16",212,299,100,611
"17","2016-01-17",276,184,79,539
"18","2016-01-18",343,137,82,562
"19","2016-01-19",270,154,79,503
"20","2016-01-20",203,116,53,372
"21","2016-01-21",157,98,27,282
"22","2016-01-22",155,126,30,311
"23","2016-01-23",91,63,15,169
"24","2016-01-24",107,37,18,162
"25","2016-01-25",147,69,66,282
"26","2016-01-26",216,148,133,497
"27","2016-01-27",456,329,206,991
"28","2016-01-28",555,268,121,944
"29","2016-01-29",324,114,69,507
"30","2016-01-30",121,60,29,210
"31","2016-01-31",109,68,39,216
"32","2016-02-01",200,71,43,314
"33","2016-02-02",168,86,49,303
"34","2016-02-03",226,120,65,411
"35","2016-02-04",276,179,113,568
"36","2016-02-05",170,83,46,299
"37","2016-02-06",79,59,25,163
"38","2016-02-07",60,56,14,130
"39","2016-02-08",50,120,59,229
"40","2016-02-09",110,116,62,288
"41","2016-02-10",112,62,34,208
"42","2016-02-11",196,88,55,339
"43","2016-02-12",193,71,26,290
"44","2016-02-13",101,82,11,194
"45","2016-02-14",76,69,17,162
"46","2016-02-15",141,68,49,258
"47","2016-02-16",167,68,51,286
"48","2016-02-17",199,58,96,353
"49","2016-02-18",281,103,104,488
"50","2016-02-19",615,531,170,1316
"51","2016-02-20",194,120,38,352
"52","2016-02-21",149,65,33,247
"53","2016-02-22",285,81,60,426
"54","2016-02-23",292,131,65,488
"55","2016-02-24",239,72,50,361
"56","2016-02-25",200,87,78,365
"57","2016-02-26",219,599,58,876
"58","2016-02-27",228,355,77,660
"59","2016-02-28",249,280,46,575
"60","2016-02-29",277,96,75,448
"61","2016-03-01",168,71,39,278
"62","2016-03-02",284,78,70,432
"63","2016-03-03",320,121,70,511
"64","2016-03-04",323,194,49,566
"65","2016-03-05",166,133,33,332
"66","2016-03-06",580,1072,181,1833
"67","2016-03-07",1354,1017,187,2558
"68","2016-03-08",1085,593,133,1811
"69","2016-03-09",669,213,103,985
"70","2016-03-10",441,126,67,634
"71","2016-03-11",383,169,57,609
"72","2016-03-12",192,118,26,336
"73","2016-03-13",230,113,59,402
"74","2016-03-14",520,239,133,892
"75","2016-03-15",640,228,152,1020
"76","2016-03-16",598,338,138,1074
"77","2016-03-17",573,217,91,881
"78","2016-03-18",601,307,127,1035
"79","2016-03-19",500,439,97,1036
"80","2016-03-20",605,489,80,1174
"81","2016-03-21",1082,427,130,1639
"82","2016-03-22",890,498,129,1517
"83","2016-03-23",932,260,145,1337
"84","2016-03-24",899,339,115,1353
"85","2016-03-25",694,211,86,991
"86","2016-03-26",450,217,71,738
"87","2016-03-27",548,283,71,902
"88","2016-03-28",1004,312,174,1490
"89","2016-03-29",1934,860,148,2942
"90","2016-03-30",2467,1530,222,4219
"91","2016-03-31",2218,926,170,3314
"92","2016-04-01",1499,665,122,2286
"93","2016-04-02",1107,819,108,2034
"94","2016-04-03",1014,465,87,1566
"95","2016-04-04",1572,422,120,2114
"96","2016-04-05",1204,315,96,1615
"97","2016-04-06",967,339,90,1396
"98","2016-04-07",945,260,91,1296
"99","2016-04-08",951,628,109,1688
"100","2016-04-09",2206,3050,134,5390
"101","2016-04-10",4031,3972,164,8167
"102","2016-04-11",5846,1968,174,7988
"103","2016-04-12",2921,844,114,3879
"104","2016-04-13",1621,529,66,2216
"105","2016-04-14",2193,898,137,3228
"106","2016-04-15",1585,501,78,2164
"107","2016-04-16",832,295,21,1148
"108","2016-04-17",784,402,46,1232
"109","2016-04-18",1723,555,126,2404
"110","2016-04-19",1189,412,93,1694
"111","2016-04-20",1088,368,99,1555
"112","2016-04-21",1047,247,72,1366
"113","2016-04-22",1541,1838,143,3522
"114","2016-04-23",3911,10856,186,14953
"115","2016-04-24",5159,8761,231,14151
"116","2016-04-25",7191,4883,246,12320
"117","2016-04-26",4925,3099,218,8242
"118","2016-04-27",3541,1777,133,5451
"119","2016-04-28",2572,1047,98,3717
"120","2016-04-29",2035,802,134,2971
"121","2016-04-30",1193,926,58,2177
"122","2016-05-01",1126,711,80,1917
"123","2016-05-02",1681,713,107,2501
"124","2016-05-03",1659,587,84,2330
"125","2016-05-04",1198,775,93,2066
"126","2016-05-05",655,406,49,1110
"127","2016-05-06",809,450,64,1323
"128","2016-05-07",1374,3158,179,4711
"129","2016-05-08",1151,842,87,2080
"130","2016-05-09",1520,702,146,2368
"131","2016-05-10",1428,700,181,2309
"132","2016-05-11",1434,680,165,2279
"133","2016-05-12",1121,455,133,1709
"134","2016-05-13",831,467,101,1399
"135","2016-05-14",514,319,51,884
"136","2016-05-15",505,282,35,822
"137","2016-05-16",947,544,172,1663
"138","2016-05-17",871,418,160,1449
"139","2016-05-18",722,332,141,1195
"140","2016-05-19",646,480,145,1271
"141","2016-05-20",575,383,91,1049
"142","2016-05-21",327,321,46,694
"143","2016-05-22",297,295,46,638
"144","2016-05-23",614,561,177,1352
"145","2016-05-24",646,405,106,1157
"146","2016-05-25",817,811,170,1798
"147","2016-05-26",2447,2453,216,5116
"148","2016-05-27",2449,2188,196,4833
"149","2016-05-28",1323,1199,111,2633
"150","2016-05-29",1051,1015,123,2189
"151","2016-05-30",2078,2446,233,4757
"152","2016-05-31",2046,2453,284,4783
"153","2016-06-01",1869,2185,375,4429
"154","2016-06-02",1488,1622,418,3528
"155","2016-06-03",1266,1897,455,3618
"156","2016-06-04",590,956,110,1656
"157","2016-06-05",525,872,155,1552
"158","2016-06-06",619,1345,144,2108
"159","2016-06-07",987,1234,205,2426
"160","2016-06-08",843,848,230,1921
"161","2016-06-09",829,751,165,1745
"162","2016-06-10",806,726,172,1704
"163","2016-06-11",456,924,63,1443
"164","2016-06-12",402,953,104,1459
"165","2016-06-13",792,729,190,1711
"166","2016-06-14",693,654,161,1508
"167","2016-06-15",644,677,91,1412
"168","2016-06-16",671,816,133,1620
"169","2016-06-17",531,824,77,1432
"170","2016-06-18",441,566,46,1053
"171","2016-06-19",304,626,75,1005
"172","2016-06-20",540,1312,105,1957
"173","2016-06-21",596,852,112,1560
"174","2016-06-22",635,1154,169,1958
"175","2016-06-23",512,806,163,1481
"176","2016-06-24",541,551,70,1162
"177","2016-06-25",325,299,29,653
"178","2016-06-26",328,207,72,607
"179","2016-06-27",575,280,100,955
"180","2016-06-28",485,465,166,1116
"181","2016-06-29",484,497,106,1087
"182","2016-06-30",475,487,117,1079
"183","2016-07-01",474,475,157,1106
"184","2016-07-02",247,610,38,895
"185","2016-07-03",242,256,48,546
"186","2016-07-04",444,242,91,777
"187","2016-07-05",403,305,100,808
"188","2016-07-06",483,337,185,1005
"189","2016-07-07",401,347,123,871
"190","2016-07-08",408,377,77,862
"191","2016-07-09",232,214,24,470
"192","2016-07-10",164,206,46,416
"193","2016-07-11",392,258,72,722
"194","2016-07-12",333,168,62,563
"195","2016-07-13",401,206,61,668
"196","2016-07-14",361,222,64,647
"197","2016-07-15",327,210,45,582
"198","2016-07-16",170,166,25,361
"199","2016-07-17",141,145,53,339
"200","2016-07-18",301,148,76,525
"201","2016-07-19",325,222,53,600
"202","2016-07-20",306,293,89,688
"203","2016-07-21",305,348,120,773
"204","2016-07-22",299,172,78,549
"205","2016-07-23",137,139,23,299
"206","2016-07-24",129,141,34,304
"207","2016-07-25",273,191,49,513
"208","2016-07-26",261,214,45,520
"209","2016-07-27",253,157,103,513
"210","2016-07-28",280,188,73,541
"211","2016-07-29",260,411,43,714
"212","2016-07-30",129,142,10,281
"213","2016-07-31",119,91,31,241
"214","2016-08-01",220,169,62,451
"215","2016-08-02",230,129,52,411
"216","2016-08-03",268,136,51,455
"217","2016-08-04",277,254,94,625
"218","2016-08-05",309,206,45,560
"219","2016-08-06",137,152,16,305
"220","2016-08-07",118,109,17,244
"221","2016-08-08",192,144,21,357
"222","2016-08-09",247,136,38,421
"223","2016-08-10",408,437,141,986
"224","2016-08-11",241,194,61,496
"225","2016-08-12",217,146,41,404
"226","2016-08-13",124,122,14,260
"227","2016-08-14",90,119,25,234
"228","2016-08-15",134,126,21,281
"229","2016-08-16",240,132,118,490
"230","2016-08-17",221,136,49,406
"231","2016-08-18",254,178,73,505
"232","2016-08-19",216,188,43,447
"233","2016-08-20",121,129,15,265
"234","2016-08-21",110,113,33,256
"235","2016-08-22",229,124,42,395
"236","2016-08-23",208,245,75,528
"237","2016-08-24",205,132,70,407
"238","2016-08-25",204,129,59,392
"239","2016-08-26",234,163,37,434
"240","2016-08-27",186,166,11,363
"241","2016-08-28",151,132,23,306
"242","2016-08-29",327,210,57,594
"243","2016-08-30",260,227,84,571
"244","2016-08-31",268,196,44,508
"245","2016-09-01",341,790,27,1158
"246","2016-09-02",239,172,41,452
"247","2016-09-03",119,141,12,272
"248","2016-09-04",105,133,23,261
"249","2016-09-05",236,228,83,547
"250","2016-09-06",525,1433,167,2125
"251","2016-09-07",1500,3969,194,5663
"252","2016-09-08",987,1197,109,2293
"253","2016-09-09",595,761,66,1422
"254","2016-09-10",300,369,45,714
"255","2016-09-11",251,224,39,514
"256","2016-09-12",373,246,82,701
"257","2016-09-13",266,227,38,531
"258","2016-09-14",129,165,34,328
"259","2016-09-15",93,168,27,288
"260","2016-09-16",128,210,16,354
"261","2016-09-17",162,179,11,352
"262","2016-09-18",153,163,30,346
"263","2016-09-19",258,210,77,545
"264","2016-09-20",329,215,70,614
"265","2016-09-21",294,182,74,550
"266","2016-09-22",310,180,84,574
"267","2016-09-23",320,209,65,594
"268","2016-09-24",190,273,39,502
"269","2016-09-25",332,464,69,865
"270","2016-09-26",465,265,91,821
"271","2016-09-27",367,173,68,608
"272","2016-09-28",323,172,66,561
"273","2016-09-29",362,166,70,598
"274","2016-09-30",291,150,47,488
"275","2016-10-01",147,158,20,325
"276","2016-10-02",149,158,18,325
"277","2016-10-03",209,172,18,399
"278","2016-10-04",265,179,36,480
"279","2016-10-05",261,179,53,493
"280","2016-10-06",268,162,41,471
"281","2016-10-07",225,172,35,432
"282","2016-10-08",138,131,23,292
"283","2016-10-09",142,208,16,366
"284","2016-10-10",248,250,65,563
"285","2016-10-11",238,278,59,575
"286","2016-10-12",317,387,90,794
"287","2016-10-13",257,253,90,600
"288","2016-10-14",587,948,124,1659
"289","2016-10-15",694,1235,88,2017
"290","2016-10-16",494,475,44,1013
"291","2016-10-17",684,428,90,1202
"292","2016-10-18",545,407,95,1047
"293","2016-10-19",592,493,114,1199
"294","2016-10-20",745,742,100,1587
"295","2016-10-21",551,370,68,989
"296","2016-10-22",269,208,27,504
"297","2016-10-23",233,246,18,497
"298","2016-10-24",353,238,59,650
"299","2016-10-25",364,237,66,667
"300","2016-10-26",474,394,77,945
"301","2016-10-27",361,243,53,657
"302","2016-10-28",260,211,38,509
"303","2016-10-29",148,204,16,368
"304","2016-10-30",141,235,39,415
"305","2016-10-31",286,208,74,568
"306","2016-11-01",240,213,56,509
"307","2016-11-02",243,220,78,541
"308","2016-11-03",299,243,88,630
"309","2016-11-04",454,383,107,944
"310","2016-11-05",495,644,54,1193
"311","2016-11-06",539,379,80,998
"312","2016-11-07",625,188,69,882
"313","2016-11-08",419,231,52,702
"314","2016-11-09",349,146,62,557
"315","2016-11-10",287,188,71,546
"316","2016-11-11",406,328,99,833
"317","2016-11-12",256,298,50,604
"318","2016-11-13",270,221,61,552
"319","2016-11-14",559,325,100,984
"320","2016-11-15",418,235,90,743
"321","2016-11-16",351,179,101,631
"322","2016-11-17",395,335,128,858
"323","2016-11-18",817,768,130,1715
"324","2016-11-19",425,382,54,861
"325","2016-11-20",312,160,49,521
"326","2016-11-21",440,217,57,714
"327","2016-11-22",338,156,74,568
"328","2016-11-23",309,147,48,504
"329","2016-11-24",277,151,52,480
"330","2016-11-25",268,143,49,460
"331","2016-11-26",158,146,26,330
"332","2016-11-27",200,268,56,524
"333","2016-11-28",531,569,162,1262
"334","2016-11-29",418,206,127,751
"335","2016-11-30",334,187,71,592
"336","2016-12-01",390,320,137,847
"337","2016-12-02",291,207,87,585
"338","2016-12-03",176,179,61,416
"339","2016-12-04",258,293,84,635
"340","2016-12-05",1083,1315,181,2579
"341","2016-12-06",608,363,104,1075
"342","2016-12-07",444,273,107,824
"343","2016-12-08",424,307,92,823
"344","2016-12-09",345,226,64,635
"345","2016-12-10",166,219,36,421
"346","2016-12-11",178,166,38,382
"347","2016-12-12",352,227,113,692
"348","2016-12-13",398,252,100,750
"349","2016-12-14",318,241,44,603
"350","2016-12-15",270,206,58,534
"351","2016-12-16",238,198,58,494
"352","2016-12-17",198,383,75,656
"353","2016-12-18",250,314,62,626
"354","2016-12-19",384,225,104,713
"355","2016-12-20",458,577,104,1139
"356","2016-12-21",355,426,60,841
"357","2016-12-22",314,249,53,616
"358","2016-12-23",255,214,58,527
"359","2016-12-24",165,164,50,379
"360","2016-12-25",172,267,70,509
"361","2016-12-26",330,193,93,616
"362","2016-12-27",272,153,65,490
"363","2016-12-28",240,171,75,486
"364","2016-12-29",270,159,61,490
"365","2016-12-30",219,157,69,445
"366","2016-12-31",177,154,54,385
"367","2017-01-01",243,314,83,640
"368","2017-01-02",635,1223,12,1870
"369","2017-01-03",1135,1204,238,2577
"370","2017-01-04",1095,821,171,2087
"371","2017-01-05",888,554,116,1558
"372","2017-01-06",721,397,96,1214
"373","2017-01-07",385,250,38,673
"374","2017-01-08",322,201,54,577
"375","2017-01-09",501,431,113,1045
"376","2017-01-10",437,303,75,815
"377","2017-01-11",382,229,78,689
"378","2017-01-12",321,214,49,584
"379","2017-01-13",274,174,35,483
"380","2017-01-14",191,153,18,362
"381","2017-01-15",177,222,27,426
"382","2017-01-16",319,170,94,583
"383","2017-01-17",414,305,99,818
"384","2017-01-18",1100,1476,178,2754
"385","2017-01-19",1661,1723,187,3571
"386","2017-01-20",737,467,65,1269
"387","2017-01-21",302,197,26,525
"388","2017-01-22",229,342,42,613
"389","2017-01-23",407,176,76,659
"390","2017-01-24",374,203,102,679
"391","2017-01-25",365,249,129,743
"392","2017-01-26",231,282,105,618
"393","2017-01-27",217,872,109,1198
"394","2017-01-28",121,212,34,367
"395","2017-01-29",122,138,30,290
"396","2017-01-30",213,174,39,426
"397","2017-01-31",355,186,80,621
"398","2017-02-01",309,178,95,582
"399","2017-02-02",315,188,93,596
"400","2017-02-03",549,477,109,1135
"401","2017-02-04",477,667,68,1212
"402","2017-02-05",423,380,57,860
"403","2017-02-06",546,251,108,905
"404","2017-02-07",451,198,100,749
"405","2017-02-08",440,209,102,751
"406","2017-02-09",355,166,69,590
"407","2017-02-10",276,182,34,492
"408","2017-02-11",178,152,20,350
"409","2017-02-12",186,161,26,373
"410","2017-02-13",399,212,84,695
"411","2017-02-14",429,257,177,863
"412","2017-02-15",534,256,129,919
"413","2017-02-16",541,367,127,1035
"414","2017-02-17",423,245,71,739
"415","2017-02-18",222,163,30,415
"416","2017-02-19",191,162,48,401
"417","2017-02-20",366,218,105,689
"418","2017-02-21",340,209,64,613
"419","2017-02-22",380,205,72,657
"420","2017-02-23",351,160,84,595
"421","2017-02-24",340,179,89,608
"422","2017-02-25",240,198,75,513
"423","2017-02-26",280,266,66,612
"424","2017-02-27",448,285,127,860
"425","2017-02-28",443,286,105,834
"426","2017-03-01",297,256,74,627
"427","2017-03-02",432,267,125,824
"428","2017-03-03",429,241,125,795
"429","2017-03-04",298,283,69,650
"430","2017-03-05",408,408,80,896
"431","2017-03-06",627,370,104,1101
"432","2017-03-07",453,267,100,820
"433","2017-03-08",496,377,110,983
"434","2017-03-09",439,265,132,836
"435","2017-03-10",420,198,107,725
"436","2017-03-11",304,419,74,797
"437","2017-03-12",697,1012,121,1830
"438","2017-03-13",1117,729,215,2061
"439","2017-03-14",771,420,136,1327
"440","2017-03-15",710,297,140,1147
"441","2017-03-16",750,459,231,1440
"442","2017-03-17",1113,1232,211,2556
"443","2017-03-18",1063,1435,106,2604
"444","2017-03-19",1584,1854,187,3625
"445","2017-03-20",3463,4664,291,8418
"446","2017-03-21",3533,7400,311,11244
"447","2017-03-22",2832,3505,236,6573
"448","2017-03-23",2479,2843,249,5571
"449","2017-03-24",1978,2012,203,4193
"450","2017-03-25",1104,1546,91,2741
"451","2017-03-26",988,1142,83,2213
"452","2017-03-27",2389,3594,232,6215
"453","2017-03-28",2784,5015,395,8194
"454","2017-03-29",2620,4575,277,7472
"455","2017-03-30",2668,4393,238,7299
"456","2017-03-31",2674,4893,156,7723
"457","2017-04-01",1415,3000,75,4490
"458","2017-04-02",1344,2383,172,3899
"459","2017-04-03",4611,3742,282,8635
"460","2017-04-04",3280,3980,406,7666
"461","2017-04-05",3440,3848,372,7660
"462","2017-04-06",2927,3050,338,6315
"463","2017-04-07",2367,2900,220,5487
"464","2017-04-08",1591,3063,155,4809
"465","2017-04-09",1793,2383,146,4322
"466","2017-04-10",2955,2748,348,6051
"467","2017-04-11",2665,1898,290,4853
"468","2017-04-12",2505,1953,324,4782
"469","2017-04-13",2260,2222,420,4902
"470","2017-04-14",2030,1553,182,3765
"471","2017-04-15",1138,1329,101,2568
"472","2017-04-16",1152,1048,98,2298
"473","2017-04-17",2087,1300,267,3654
"474","2017-04-18",1948,1436,293,3677
"475","2017-04-19",2446,3756,335,6537
"476","2017-04-20",2508,2646,321,5475
"477","2017-04-21",2333,2377,256,4966
"478","2017-04-22",1409,1680,114,3203
"479","2017-04-23",1378,1054,152,2584
"480","2017-04-24",2300,1185,243,3728
"481","2017-04-25",1871,1357,258,3486
"482","2017-04-26",1744,1032,362,3138
"483","2017-04-27",1676,1052,326,3054
"484","2017-04-28",1490,958,225,2673
"485","2017-04-29",890,1305,98,2293
"486","2017-04-30",1239,2320,127,3686
"487","2017-05-01",2040,3651,241,5932
"488","2017-05-02",2282,3811,226,6319
"489","2017-05-03",1515,2040,178,3733
"490","2017-05-04",1614,1673,224,3511
"491","2017-05-05",1143,3120,167,4430
"492","2017-05-06",4072,31093,351,35516
"493","2017-05-07",4671,13555,342,18568
"494","2017-05-08",6319,12237,438,18994
"495","2017-05-09",4809,6053,292,11154
"496","2017-05-10",4540,3761,299,8600
"497","2017-05-11",3692,2830,276,6798
"498","2017-05-12",3786,3226,310,7322
"499","2017-05-13",2282,2402,125,4809
"500","2017-05-14",2199,1984,139,4322
"501","2017-05-15",3560,2649,449,6658
"502","2017-05-16",3183,2018,506,5707
"503","2017-05-17",2885,1652,362,4899
"504","2017-05-18",2341,1114,266,3721
"505","2017-05-19",1858,1221,293,3372
"506","2017-05-20",1122,922,107,2151
"507","2017-05-21",1108,791,200,2099
"508","2017-05-22",1910,883,319,3112
"509","2017-05-23",1566,812,230,2608
"510","2017-05-24",1570,873,228,2671
"511","2017-05-25",1445,847,265,2557
"512","2017-05-26",1801,1380,275,3456
"513","2017-05-27",1162,690,171,2023
"514","2017-05-28",1083,703,180,1966
"515","2017-05-29",1675,1217,290,3182
"516","2017-05-30",1566,1188,294,3048
"517","2017-05-31",1351,640,251,2242
"518","2017-06-01",1154,696,319,2169
"519","2017-06-02",1091,719,256,2066
"520","2017-06-03",679,534,103,1316
"521","2017-06-04",798,519,179,1496
"522","2017-06-05",1256,480,289,2025
"523","2017-06-06",754,408,109,1271
"524","2017-06-07",1029,407,151,1587
"525","2017-06-08",993,558,255,1806
"526","2017-06-09",899,527,181,1607
"527","2017-06-10",561,484,64,1109
"528","2017-06-11",561,435,147,1143
"529","2017-06-12",951,419,239,1609
"530","2017-06-13",735,384,182,1301
"531","2017-06-14",744,390,209,1343
"532","2017-06-15",660,333,149,1142
"533","2017-06-16",722,722,88,1532
"534","2017-06-17",428,333,76,837
"535","2017-06-18",408,307,75,790
"536","2017-06-19",686,453,196,1335
"537","2017-06-20",707,414,158,1279
"538","2017-06-21",669,414,155,1238
"539","2017-06-22",580,326,131,1037
"540","2017-06-23",479,320,113,912
"541","2017-06-24",291,264,36,591
"542","2017-06-25",345,356,77,778
"543","2017-06-26",581,471,260,1312
"544","2017-06-27",547,343,238,1128
"545","2017-06-28",504,353,144,1001
"546","2017-06-29",558,370,178,1106
"547","2017-06-30",588,418,171,1177
"548","2017-07-01",355,296,45,696
"549","2017-07-02",334,234,64,632
"550","2017-07-03",499,311,152,962
"551","2017-07-04",453,278,146,877
"552","2017-07-05",455,338,142,935
"553","2017-07-06",468,330,108,906
"554","2017-07-07",436,328,103,867
"555","2017-07-08",224,273,35,532
"556","2017-07-09",174,201,49,424
"557","2017-07-10",375,254,127,756
"558","2017-07-11",430,401,187,1018
"559","2017-07-12",449,420,114,983
"560","2017-07-13",426,284,120,830
"561","2017-07-14",424,319,80,823
"562","2017-07-15",213,148,35,396
"563","2017-07-16",193,157,87,437
"564","2017-07-17",355,202,109,666
"565","2017-07-18",376,206,99,681
"566","2017-07-19",485,380,222,1087
"567","2017-07-20",460,366,141,967
"568","2017-07-21",425,346,106,877
"569","2017-07-22",216,340,54,610
"570","2017-07-23",215,322,49,586
"571","2017-07-24",404,256,95,755
"572","2017-07-25",371,409,151,931
"573","2017-07-26",469,378,131,978
"574","2017-07-27",359,235,113,707
"575","2017-07-28",290,217,79,586
"576","2017-07-29",185,193,22,400
"577","2017-07-30",165,146,33,344
"578","2017-07-31",315,180,95,590
"579","2017-08-01",307,206,103,616
"580","2017-08-02",294,222,129,645
"581","2017-08-03",304,229,96,629
"582","2017-08-04",277,217,73,567
"583","2017-08-05",175,192,18,385
"584","2017-08-06",188,207,22,417
"585","2017-08-07",289,270,75,634
"586","2017-08-08",307,224,79,610
"587","2017-08-09",284,210,86,580
"588","2017-08-10",273,162,73,508
"589","2017-08-11",275,235,68,578
"590","2017-08-12",179,199,21,399
"591","2017-08-13",157,145,49,351
"592","2017-08-14",276,152,48,476
"593","2017-08-15",197,146,27,370
"594","2017-08-16",311,174,79,564
"595","2017-08-17",293,164,97,554
"596","2017-08-18",267,189,63,519
"597","2017-08-19",146,135,37,318
"598","2017-08-20",136,152,24,312
"599","2017-08-21",329,180,104,613
"600","2017-08-22",276,161,87,524
"601","2017-08-23",310,153,79,542
"602","2017-08-24",257,160,89,506
"603","2017-08-25",267,168,99,534
"604","2017-08-26",151,168,42,361
"605","2017-08-27",140,145,36,321
"606","2017-08-28",304,152,81,537
"607","2017-08-29",340,167,117,624
"608","2017-08-30",300,143,103,546
"609","2017-08-31",311,181,84,576
"610","2017-09-01",263,157,108,528
"611","2017-09-02",118,147,38,303
"612","2017-09-03",130,161,45,336
"613","2017-09-04",300,155,91,546
"614","2017-09-05",257,149,98,504
"615","2017-09-06",298,173,80,551
"616","2017-09-07",351,189,101,641
"617","2017-09-08",502,955,149,1606
"618","2017-09-09",389,806,80,1275
"619","2017-09-10",481,608,102,1191
"620","2017-09-11",609,297,114,1020
"621","2017-09-12",491,230,121,842
"622","2017-09-13",430,201,96,727
"623","2017-09-14",408,155,125,688
"624","2017-09-15",379,172,101,652
"625","2017-09-16",225,156,26,407
"626","2017-09-17",262,221,47,530
"627","2017-09-18",484,200,114,798
"628","2017-09-19",1522,4018,226,5766
"629","2017-09-20",1233,1213,229,2675
"630","2017-09-21",757,391,119,1267
"631","2017-09-22",548,289,103,940
"632","2017-09-23",431,532,96,1059
"633","2017-09-24",712,833,123,1668
"634","2017-09-25",1143,774,220,2137
"635","2017-09-26",798,526,190,1514
"636","2017-09-27",662,368,158,1188
"637","2017-09-28",518,263,142,923
"638","2017-09-29",409,274,96,779
"639","2017-09-30",264,194,38,496
"640","2017-10-01",198,170,26,394
"641","2017-10-02",212,184,31,427
"642","2017-10-03",156,182,29,367
"643","2017-10-04",115,144,18,277
"644","2017-10-05",122,143,32,297
"645","2017-10-06",155,170,30,355
"646","2017-10-07",165,214,44,423
"647","2017-10-08",161,152,47,360
"648","2017-10-09",214,178,39,431
"649","2017-10-10",322,231,72,625
"650","2017-10-11",327,200,109,636
"651","2017-10-12",327,180,100,607
"652","2017-10-13",280,185,94,559
"653","2017-10-14",178,151,36,365
"654","2017-10-15",177,163,88,428
"655","2017-10-16",340,188,121,649
"656","2017-10-17",361,172,104,637
"657","2017-10-18",346,195,85,626
"658","2017-10-19",303,165,90,558
"659","2017-10-20",283,173,60,516
"660","2017-10-21",168,166,30,364
"661","2017-10-22",169,173,35,377
"662","2017-10-23",299,177,87,563
"663","2017-10-24",299,141,94,534
"664","2017-10-25",343,251,162,756
"665","2017-10-26",633,652,218,1503
"666","2017-10-27",689,680,150,1519
"667","2017-10-28",307,265,53,625
"668","2017-10-29",337,452,58,847
"669","2017-10-30",461,288,90,839
"670","2017-10-31",400,237,125,762
"671","2017-11-01",407,374,142,923
"672","2017-11-02",442,341,109,892
"673","2017-11-03",410,293,72,775
"674","2017-11-04",282,358,70,710
"675","2017-11-05",283,226,87,596
"676","2017-11-06",470,246,119,835
"677","2017-11-07",446,270,101,817
"678","2017-11-08",833,1122,212,2167
"679","2017-11-09",556,416,162,1134
"680","2017-11-10",518,398,133,1049
"681","2017-11-11",314,619,90,1023
"682","2017-11-12",333,280,86,699
"683","2017-11-13",484,332,174,990
"684","2017-11-14",469,373,166,1008
"685","2017-11-15",407,228,136,771
"686","2017-11-16",296,228,65,589
"687","2017-11-17",259,218,40,517
"688","2017-11-18",144,145,20,309
"689","2017-11-19",184,172,30,386
"690","2017-11-20",351,219,96,666
"691","2017-11-21",369,245,115,729
"692","2017-11-22",361,371,145,877
"693","2017-11-23",351,218,86,655
"694","2017-11-24",306,217,67,590
"695","2017-11-25",144,170,36,350
"696","2017-11-26",180,188,55,423
"697","2017-11-27",340,216,104,660
"698","2017-11-28",534,520,172,1226
"699","2017-11-29",555,402,112,1069
"700","2017-11-30",386,185,76,647
"701","2017-12-01",303,159,71,533
"702","2017-12-02",157,120,47,324
"703","2017-12-03",193,236,78,507
"704","2017-12-04",357,268,97,722
"705","2017-12-05",342,187,68,597
"706","2017-12-06",295,137,97,529
"707","2017-12-07",305,229,115,649
"708","2017-12-08",247,187,62,496
"709","2017-12-09",139,125,33,297
"710","2017-12-10",131,169,39,339
"711","2017-12-11",280,212,65,557
"712","2017-12-12",268,253,99,620
"713","2017-12-13",272,208,119,599
"714","2017-12-14",307,254,172,733
"715","2017-12-15",342,454,195,991
"716","2017-12-16",137,168,40,345
"717","2017-12-17",123,255,77,455
"718","2017-12-18",279,190,138,607
"719","2017-12-19",305,142,124,571
"720","2017-12-20",234,142,117,493
"721","2017-12-21",265,137,127,529
"722","2017-12-22",275,312,134,721
"723","2017-12-23",438,1862,140,2440
"724","2017-12-24",533,1417,157,2107
"725","2017-12-25",381,377,82,840
"726","2017-12-26",475,283,106,864
"727","2017-12-27",399,224,100,723
"728","2017-12-28",399,312,155,866
"729","2017-12-29",646,1188,258,2092
"730","2017-12-30",850,2430,190,3470
"731","2017-12-31",630,851,115,1596
"732","2018-01-01",399,239,91,729
"733","2018-01-02",572,244,114,930
"734","2018-01-03",504,295,90,889
"735","2018-01-04",453,276,105,834
"736","2018-01-05",411,268,108,787
"737","2018-01-06",240,237,64,541
"738","2018-01-07",275,264,54,593
"739","2018-01-08",460,442,85,987
"740","2018-01-09",413,377,94,884
"741","2018-01-10",358,247,85,690
"742","2018-01-11",341,192,73,606
"743","2018-01-12",300,231,63,594
"744","2018-01-13",277,321,82,680
"745","2018-01-14",789,2387,289,3465
"746","2018-01-15",2498,4502,773,7773
"747","2018-01-16",2664,5668,623,8955
"748","2018-01-17",4373,6643,1107,12123
"749","2018-01-18",4653,5495,941,11089
"750","2018-01-19",3667,3092,473,7232
"751","2018-01-20",2205,3648,213,6066
"752","2018-01-21",2322,3032,296,5650
"753","2018-01-22",3050,2387,430,5867
"754","2018-01-23",2272,1902,345,4519
"755","2018-01-24",1645,1339,246,3230
"756","2018-01-25",1468,1224,380,3072
"757","2018-01-26",1107,844,103,2054
"758","2018-01-27",661,666,52,1379
"759","2018-01-28",652,499,84,1235
"760","2018-01-29",993,876,182,2051
"761","2018-01-30",1078,1117,220,2415
"762","2018-01-31",1022,771,176,1969
"763","2018-02-01",926,582,261,1769
"764","2018-02-02",867,504,110,1481
"765","2018-02-03",572,366,41,979
"766","2018-02-04",545,323,87,955
"767","2018-02-05",826,435,160,1421
"768","2018-02-06",802,568,200,1570
"769","2018-02-07",775,433,157,1365
"770","2018-02-08",772,508,167,1447
"771","2018-02-09",1028,1042,168,2238
"772","2018-02-10",817,825,125,1767
"773","2018-02-11",468,474,40,982
"774","2018-02-12",811,302,100,1213
"775","2018-02-13",799,446,147,1392
"776","2018-02-14",750,714,171,1635
"777","2018-02-15",393,317,95,805
"778","2018-02-16",269,220,85,574
"779","2018-02-17",308,244,66,618
"780","2018-02-18",404,224,79,707
"781","2018-02-19",788,314,219,1321
"782","2018-02-20",1060,696,251,2007
"783","2018-02-21",942,377,197,1516
"784","2018-02-22",825,330,183,1338
"785","2018-02-23",1122,1206,248,2576
"786","2018-02-24",985,947,118,2050
"787","2018-02-25",818,394,75,1287
"788","2018-02-26",1205,636,192,2033
"789","2018-02-27",1803,1802,420,4025
"790","2018-02-28",1902,1556,426,3884
"791","2018-03-01",970,640,115,1725
"792","2018-03-02",1008,539,166,1713
"793","2018-03-03",721,696,76,1493
"794","2018-03-04",742,537,75,1354
"795","2018-03-05",1306,804,203,2313
"796","2018-03-06",1105,441,209,1755
"797","2018-03-07",1039,456,170,1665
"798","2018-03-08",1045,359,132,1536
"799","2018-03-09",1059,535,179,1773
"800","2018-03-10",727,530,94,1351
"801","2018-03-11",933,710,186,1829
"802","2018-03-12",1945,1953,316,4214
"803","2018-03-13",2328,2139,315,4782
"804","2018-03-14",1911,1536,236,3683
"805","2018-03-15",1463,531,183,2177
"806","2018-03-16",1337,751,223,2311
"807","2018-03-17",837,481,91,1409
"808","2018-03-18",937,643,120,1700
"809","2018-03-19",1331,644,208,2183
"810","2018-03-20",1121,648,256,2025
"811","2018-03-21",1009,698,194,1901
"812","2018-03-22",1053,674,211,1938
"813","2018-03-23",1479,1306,366,3151
"814","2018-03-24",1976,4233,172,6381
"815","2018-03-25",4576,13051,592,18219
"816","2018-03-26",9912,29623,1385,40920
"817","2018-03-27",8699,14369,1257,24325
"818","2018-03-28",7609,9596,837,18042
"819","2018-03-29",6761,6478,827,14066
"820","2018-03-30",5496,4594,462,10552
"821","2018-03-31",3314,3677,179,7170
"822","2018-04-01",3265,3342,236,6843
"823","2018-04-02",4460,3315,388,8163
"824","2018-04-03",3731,2375,311,6417
"825","2018-04-04",4108,2430,560,7098
"826","2018-04-05",3632,1406,453,5491
"827","2018-04-06",3746,6501,688,10935
"828","2018-04-07",2722,2904,224,5850
"829","2018-04-08",2242,1822,258,4322
"830","2018-04-09",4774,2718,597,8089
"831","2018-04-10",3211,2153,448,5812
"832","2018-04-11",3721,2835,552,7108
"833","2018-04-12",3258,1505,507,5270
"834","2018-04-13",2655,1346,292,4293
"835","2018-04-14",1521,721,146,2388
"836","2018-04-15",2862,4042,396,7300
"837","2018-04-16",4137,2006,475,6618
"838","2018-04-17",3470,1603,446,5519
"839","2018-04-18",3695,2167,403,6265
"840","2018-04-19",3454,1783,377,5614
"841","2018-04-20",3742,3995,390,8127
"842","2018-04-21",2926,4003,151,7080
"843","2018-04-22",2687,1494,162,4343
"844","2018-04-23",3605,1238,212,5055
"845","2018-04-24",3197,949,293,4439
"846","2018-04-25",3118,1272,375,4765
"847","2018-04-26",2431,1145,271,3847
"848","2018-04-27",2147,994,194,3335
"849","2018-04-28",1838,1636,111,3585
"850","2018-04-29",1996,1243,165,3404
"851","2018-04-30",3363,2096,323,5782
"852","2018-05-01",3194,1954,258,5406
"853","2018-05-02",3104,1180,260,4544
"854","2018-05-03",2631,1152,323,4106
"855","2018-05-04",2234,915,263,3412
"856","2018-05-05",1327,825,154,2306
"857","2018-05-06",1372,443,81,1896
"858","2018-05-07",1609,489,159,2257
"859","2018-05-08",2113,754,308,3175
"860","2018-05-09",2143,493,368,3004
"861","2018-05-10",2070,541,264,2875
"862","2018-05-11",1890,1029,185,3104
"863","2018-05-12",1253,449,67,1769
"864","2018-05-13",1247,330,137,1714
"865","2018-05-14",2106,1084,317,3507
"866","2018-05-15",2287,1904,323,4514
"867","2018-05-16",1891,837,250,2978
"868","2018-05-17",1614,785,286,2685
"869","2018-05-18",1490,527,174,2191
"870","2018-05-19",1427,788,104,2319
"871","2018-05-20",1607,414,130,2151
"872","2018-05-21",2275,636,274,3185
"873","2018-05-22",1388,313,136,1837
"874","2018-05-23",2168,1003,313,3484
"875","2018-05-24",2395,1332,489,4216
"876","2018-05-25",2271,1465,254,3990
"877","2018-05-26",1499,860,120,2479
"878","2018-05-27",1444,682,136,2262
"879","2018-05-28",2059,691,290,3040
"880","2018-05-29",1794,684,318,2796
"881","2018-05-30",1667,575,293,2535
"882","2018-05-31",1625,594,316,2535
"883","2018-06-01",1362,610,202,2174
"884","2018-06-02",828,319,108,1255
"885","2018-06-03",990,334,149,1473
"886","2018-06-04",1258,735,255,2248
"887","2018-06-05",1246,540,241,2027
"888","2018-06-06",926,545,123,1594
"889","2018-06-07",1446,682,255,2383
"890","2018-06-08",1341,488,180,2009
"891","2018-06-09",827,388,76,1291
"892","2018-06-10",932,405,80,1417
"893","2018-06-11",1368,398,165,1931
"894","2018-06-12",1342,397,180,1919
"895","2018-06-13",847,181,111,1139
"896","2018-06-14",1057,289,229,1575
"897","2018-06-15",1021,367,141,1529
"898","2018-06-16",709,412,83,1204
"899","2018-06-17",808,321,112,1241
"900","2018-06-18",1201,519,189,1909
"901","2018-06-19",1035,489,171,1695
"902","2018-06-20",1068,393,165,1626
"903","2018-06-21",1012,403,163,1578
"904","2018-06-22",939,278,133,1350
"905","2018-06-23",560,249,78,887
"906","2018-06-24",697,449,113,1259
"907","2018-06-25",1046,575,185,1806
"908","2018-06-26",1137,610,212,1959
"909","2018-06-27",1021,378,154,1553
"910","2018-06-28",811,291,201,1303
"911","2018-06-29",801,274,153,1228
"912","2018-06-30",548,359,38,945
"913","2018-07-01",528,275,59,862
"914","2018-07-02",839,304,146,1289
"915","2018-07-03",878,419,186,1483
"916","2018-07-04",1008,404,142,1554
"917","2018-07-05",866,280,142,1288
"918","2018-07-06",837,386,226,1449
"919","2018-07-07",748,538,75,1361
"920","2018-07-08",758,284,67,1109
"921","2018-07-09",1000,313,149,1462
"922","2018-07-10",925,280,131,1336
"923","2018-07-11",791,238,157,1186
"924","2018-07-12",784,298,164,1246
"925","2018-07-13",741,201,91,1033
"926","2018-07-14",531,163,62,756
"927","2018-07-15",522,190,94,806
"928","2018-07-16",827,295,125,1247
"929","2018-07-17",736,439,169,1344
"930","2018-07-18",800,416,250,1466
"931","2018-07-19",743,429,158,1330
"932","2018-07-20",746,723,150,1619
"933","2018-07-21",555,531,84,1170
"934","2018-07-22",539,407,70,1016
"935","2018-07-23",733,384,195,1312
"936","2018-07-24",726,305,142,1173
"937","2018-07-25",671,295,153,1119
"938","2018-07-26",663,297,183,1143
"939","2018-07-27",664,358,114,1136
"940","2018-07-28",425,300,51,776
"941","2018-07-29",456,236,50,742
"942","2018-07-30",744,352,129,1225
"943","2018-07-31",700,320,131,1151
"944","2018-08-01",650,313,112,1075
"945","2018-08-02",561,335,101,997
"946","2018-08-03",591,345,153,1089
"947","2018-08-04",403,205,46,654
"948","2018-08-05",424,188,45,657
"949","2018-08-06",576,197,114,887
"950","2018-08-07",571,184,113,868
"951","2018-08-08",588,186,137,911
"952","2018-08-09",560,232,101,893
"953","2018-08-10",556,177,83,816
"954","2018-08-11",386,201,33,620
"955","2018-08-12",412,173,43,628
"956","2018-08-13",568,199,110,877
"957","2018-08-14",543,189,112,844
"958","2018-08-15",446,123,61,630
"959","2018-08-16",563,273,125,961
"960","2018-08-17",581,279,78,938
"961","2018-08-18",407,229,34,670
"962","2018-08-19",401,223,45,669
"963","2018-08-20",582,230,103,915
"964","2018-08-21",576,328,145,1049
"965","2018-08-22",548,305,98,951
"966","2018-08-23",517,301,87,905
"967","2018-08-24",478,266,72,816
"968","2018-08-25",232,190,38,460
"969","2018-08-26",233,175,47,455
"970","2018-08-27",423,197,130,750
"971","2018-08-28",464,278,217,959
"972","2018-08-29",459,210,103,772
"973","2018-08-30",424,205,133,762
"974","2018-08-31",419,232,101,752
"975","2018-09-01",214,150,29,393
"976","2018-09-02",238,166,67,471
"977","2018-09-03",452,241,103,796
"978","2018-09-04",449,252,128,829
"979","2018-09-05",512,202,143,857
"980","2018-09-06",413,172,184,769
"981","2018-09-07",384,200,84,668
"982","2018-09-08",262,192,36,490
"983","2018-09-09",267,169,68,504
"984","2018-09-10",540,229,143,912
"985","2018-09-11",503,230,114,847
"986","2018-09-12",483,184,138,805
"987","2018-09-13",492,200,104,796
"988","2018-09-14",434,177,101,712
"989","2018-09-15",255,178,37,470
"990","2018-09-16",291,232,47,570
"991","2018-09-17",505,265,97,867
"992","2018-09-18",537,295,173,1005
"993","2018-09-19",608,286,118,1012
"994","2018-09-20",459,263,73,795
"995","2018-09-21",396,199,64,659
"996","2018-09-22",234,248,42,524
"997","2018-09-23",161,225,49,435
"998","2018-09-24",160,232,44,436
"999","2018-09-25",226,252,40,518
"1000","2018-09-26",246,224,39,509
"1001","2018-09-27",474,142,109,725
"1002","2018-09-28",414,144,97,655
"1003","2018-09-29",299,65,45,409
"1004","2018-09-30",303,99,63,465
"1005","2018-10-01",569,204,95,868
"1006","2018-10-02",483,192,97,772
"1007","2018-10-03",322,166,54,542
"1008","2018-10-04",477,236,120,833
"1009","2018-10-05",393,235,114,742
"1010","2018-10-06",226,195,21,442
"1011","2018-10-07",238,166,49,453
"1012","2018-10-08",419,261,114,794
"1013","2018-10-09",290,245,98,633
"1014","2018-10-10",475,246,142,863
"1015","2018-10-11",412,287,129,828
"1016","2018-10-12",386,251,109,746
"1017","2018-10-13",246,230,39,515
"1018","2018-10-14",291,395,88,774
"1019","2018-10-15",1446,1967,276,3689
"1020","2018-10-16",2204,2537,246,4987
"1021","2018-10-17",1761,1222,205,3188
"1022","2018-10-18",1119,531,110,1760
"1023","2018-10-19",878,448,106,1432
"1024","2018-10-20",477,329,79,885
"1025","2018-10-21",544,382,99,1025
"1026","2018-10-22",1033,700,221,1954
"1027","2018-10-23",1353,2111,239,3703
"1028","2018-10-24",1137,635,241,2013
"1029","2018-10-25",861,378,134,1373
"1030","2018-10-26",752,501,90,1343
"1031","2018-10-27",444,317,53,814
"1032","2018-10-28",391,296,77,764
"1033","2018-10-29",617,389,136,1142
"1034","2018-10-30",577,361,163,1101
"1035","2018-10-31",620,351,137,1108
"1036","2018-11-01",542,264,118,924
"1037","2018-11-02",535,333,125,993
"1038","2018-11-03",435,703,70,1208
"1039","2018-11-04",753,594,131,1478
"1040","2018-11-05",1632,1381,219,3232
"1041","2018-11-06",3604,7795,408,11807
"1042","2018-11-07",5994,7551,726,14271
"1043","2018-11-08",4655,3046,415,8116
"1044","2018-11-09",3378,2339,300,6017
"1045","2018-11-10",2304,2329,138,4771
"1046","2018-11-11",2779,2721,206,5706
"1047","2018-11-12",3851,1630,315,5796
"1048","2018-11-13",2668,1124,365,4157
"1049","2018-11-14",2214,968,255,3437
"1050","2018-11-15",1917,996,278,3191
"1051","2018-11-16",2080,1453,234,3767
"1052","2018-11-17",1190,892,126,2208
"1053","2018-11-18",1168,684,114,1966
"1054","2018-11-19",2057,1042,286,3385
"1055","2018-11-20",1647,819,278,2744
"1056","2018-11-21",1520,748,227,2495
"1057","2018-11-22",1325,605,196,2126
"1058","2018-11-23",1066,541,137,1744
"1059","2018-11-24",557,540,73,1170
"1060","2018-11-25",833,780,124,1737
"1061","2018-11-26",1753,1408,311,3472
"1062","2018-11-27",3679,5461,432,9572
"1063","2018-11-28",4879,6256,451,11586
"1064","2018-11-29",3578,2748,298,6624
"1065","2018-11-30",3079,2081,221,5381
"1066","2018-12-01",1732,1110,105,2947
"1067","2018-12-02",1660,739,96,2495
"1068","2018-12-03",2497,1028,246,3771
"1069","2018-12-04",2187,892,198,3277
"1070","2018-12-05",1584,610,196,2390
"1071","2018-12-06",1337,501,129,1967
"1072","2018-12-07",1185,670,101,1956
"1073","2018-12-08",700,537,65,1302
"1074","2018-12-09",613,469,65,1147
"1075","2018-12-10",1163,536,143,1842
"1076","2018-12-11",1134,594,172,1900
"1077","2018-12-12",1091,503,190,1784
"1078","2018-12-13",996,433,154,1583
"1079","2018-12-14",814,331,124,1269
"1080","2018-12-15",635,341,79,1055
"1081","2018-12-16",679,528,123,1330
"1082","2018-12-17",1534,1454,354,3342
"1083","2018-12-18",1530,1372,334,3236
"1084","2018-12-19",1678,1197,247,3122
"1085","2018-12-20",1854,1285,239,3378
"1086","2018-12-21",1992,1547,220,3759
"1087","2018-12-22",1456,2004,134,3594
"1088","2018-12-23",1228,1073,132,2433
"1089","2018-12-24",1406,670,180,2256
"1090","2018-12-25",720,397,130,1247
"1091","2018-12-26",1208,511,205,1924
"1092","2018-12-27",1091,510,138,1739
"1093","2018-12-28",884,504,170,1558
"1094","2018-12-29",523,360,74,957
"1095","2018-12-30",555,333,101,989
"1096","2018-12-31",821,417,138,1376
"1097","2019-01-01",447,288,104,839
"1098","2019-01-02",857,425,221,1503
"1099","2019-01-03",901,561,153,1615
"1100","2019-01-04",1063,985,200,2248
"1101","2019-01-05",971,980,112,2063
"1102","2019-01-06",865,396,120,1381
"1103","2019-01-07",1373,718,220,2311
"1104","2019-01-08",1401,679,248,2328
"1105","2019-01-09",1158,473,193,1824
"1106","2019-01-10",1294,562,204,2060
"1107","2019-01-11",1649,1132,215,2996
"1108","2019-01-12",1758,2276,154,4188
"1109","2019-01-13",2556,3731,284,6571
"1110","2019-01-14",7604,17044,876,25524
"1111","2019-01-15",8650,16971,1008,26629
"1112","2019-01-16",6751,4991,624,12366
"1113","2019-01-17",4762,2876,398,8036
"1114","2019-01-18",3863,2409,346,6618
"1115","2019-01-19",2956,3500,190,6646
"1116","2019-01-20",2767,1789,226,4782
"1117","2019-01-21",3715,1881,397,5993
"1118","2019-01-22",3273,1731,524,5528
"1119","2019-01-23",3399,2837,451,6687
"1120","2019-01-24",2784,1384,390,4558
"1121","2019-01-25",2301,1177,354,3832
"1122","2019-01-26",1371,903,151,2425
"1123","2019-01-27",1314,786,189,2289
"1124","2019-01-28",1992,1065,429,3486
"1125","2019-01-29",1860,1220,346,3426
"1126","2019-01-30",1819,1016,304,3139
"1127","2019-01-31",1726,803,222,2751
"1128","2019-02-01",1327,723,212,2262
"1129","2019-02-02",885,757,117,1759
"1130","2019-02-03",803,870,96,1769
"1131","2019-02-04",792,934,138,1864
"1132","2019-02-05",629,862,114,1605
"1133","2019-02-06",920,1016,257,2193
"1134","2019-02-07",1552,1272,354,3178
"1135","2019-02-08",1478,895,224,2597
"1136","2019-02-09",909,617,74,1600
"1137","2019-02-10",941,679,111,1731
"1138","2019-02-11",1464,618,285,2367
"1139","2019-02-12",1853,961,284,3098
"1140","2019-02-13",1711,843,303,2857
"1141","2019-02-14",1586,686,293,2565
"1142","2019-02-15",1390,888,299,2577
"1143","2019-02-16",890,686,92,1668
"1144","2019-02-17",920,726,146,1792
"1145","2019-02-18",1489,615,297,2401
"1146","2019-02-19",1426,677,267,2370
"1147","2019-02-20",1853,1186,483,3522
"1148","2019-02-21",2847,2756,453,6056
"1149","2019-02-22",3553,3247,461,7261
"1150","2019-02-23",2364,2877,165,5406
"1151","2019-02-24",2219,2020,160,4399
"1152","2019-02-25",3918,2860,443,7221
"1153","2019-02-26",3096,1699,361,5156
"1154","2019-02-27",2846,1191,306,4343
"1155","2019-02-28",3035,2345,366,5746
"1156","2019-03-01",3337,5541,242,9120
"1157","2019-03-02",4230,6459,158,10847
"1158","2019-03-03",4799,6537,222,11558
"1159","2019-03-04",7605,14061,726,22392
"1160","2019-03-05",11132,33639,1367,46138
"1161","2019-03-06",12033,27471,2093,41597
"1162","2019-03-07",10489,16460,1604,28553
"1163","2019-03-08",8696,8062,815,17573
"1164","2019-03-09",5242,4548,248,10038
"1165","2019-03-10",5084,3818,314,9216
"1166","2019-03-11",6711,4207,716,11634
"1167","2019-03-12",6325,5032,1084,12441
"1168","2019-03-13",6140,4137,953,11230
"1169","2019-03-14",5092,2472,616,8180
"1170","2019-03-15",4320,2440,370,7130
"1171","2019-03-16",2826,1694,149,4669
"1172","2019-03-17",2930,1914,307,5151
"1173","2019-03-18",4694,2051,636,7381
"1174","2019-03-19",4341,2287,621,7249
"1175","2019-03-20",5253,5061,813,11127
"1176","2019-03-21",4323,2659,655,7637
"1177","2019-03-22",3707,1993,517,6217
"1178","2019-03-23",2178,1743,147,4068
"1179","2019-03-24",2700,1622,238,4560
"1180","2019-03-25",4043,2169,568,6780
"1181","2019-03-26",4238,2538,705,7481
"1182","2019-03-27",4850,3724,707,9281
"1183","2019-03-28",4637,3439,774,8850
"1184","2019-03-29",3843,2234,374,6451
"1185","2019-03-30",2043,1355,139,3537
"1186","2019-03-31",2148,2418,268,4834
"1187","2019-04-01",3479,1632,574,5685
"1188","2019-04-02",3167,1224,575,4966
"1189","2019-04-03",2999,1055,519,4573
"1190","2019-04-04",2823,1192,489,4504
"1191","2019-04-05",2841,1817,464,5122
"1192","2019-04-06",1710,1063,149,2922
"1193","2019-04-07",1888,1116,213,3217
"1194","2019-04-08",2861,1010,491,4362
"1195","2019-04-09",2504,892,429,3825
"1196","2019-04-10",2275,902,419,3596
"1197","2019-04-11",2270,1063,386,3719
"1198","2019-04-12",2175,843,324,3342
"1199","2019-04-13",1315,937,132,2384
"1200","2019-04-14",1382,476,141,1999
"1201","2019-04-15",2141,778,441,3360
"1202","2019-04-16",2077,772,361,3210
"1203","2019-04-17",2031,826,443,3300
"1204","2019-04-18",1894,737,590,3221
"1205","2019-04-19",1708,659,338,2705
"1206","2019-04-20",1011,563,123,1697
"1207","2019-04-21",980,595,157,1732
"1208","2019-04-22",1957,1533,489,3979
"1209","2019-04-23",2206,1540,359,4105
"1210","2019-04-24",1923,1052,611,3586
"1211","2019-04-25",1751,700,378,2829
"1212","2019-04-26",1484,542,246,2272
"1213","2019-04-27",1125,645,75,1845
"1214","2019-04-28",1037,496,163,1696
"1215","2019-04-29",1842,631,435,2908
"1216","2019-04-30",1789,740,396,2925
