"","social_health.date","social_health.blog","social_health.twitter","social_health.news","social_health.total"
"1","2016-01-01",3606,5325,455,9386
"2","2016-01-02",2825,3318,195,6338
"3","2016-01-03",2581,3014,350,5945
"4","2016-01-04",5422,3381,945,9748
"5","2016-01-05",5257,3675,679,9611
"6","2016-01-06",5038,3668,855,9561
"7","2016-01-07",5244,3598,765,9607
"8","2016-01-08",4881,3524,648,9053
"9","2016-01-09",2619,2669,211,5499
"10","2016-01-10",2393,3412,370,6175
"11","2016-01-11",5111,3374,922,9407
"12","2016-01-12",5046,2999,860,8905
"13","2016-01-13",4907,3096,766,8769
"14","2016-01-14",5033,2729,747,8509
"15","2016-01-15",4445,3095,688,8228
"16","2016-01-16",2422,3224,218,5864
"17","2016-01-17",2293,2544,260,5097
"18","2016-01-18",5287,2745,903,8935
"19","2016-01-19",5527,3405,812,9744
"20","2016-01-20",5427,2751,894,9072
"21","2016-01-21",5279,3013,781,9073
"22","2016-01-22",5078,3506,681,9265
"23","2016-01-23",2954,3609,282,6845
"24","2016-01-24",2729,3764,370,6863
"25","2016-01-25",5534,4550,796,10880
"26","2016-01-26",5077,4291,736,10104
"27","2016-01-27",4856,4423,898,10177
"28","2016-01-28",4595,4319,809,9723
"29","2016-01-29",4522,4657,617,9796
"30","2016-01-30",2530,3527,219,6276
"31","2016-01-31",2345,3434,327,6106
"32","2016-02-01",4625,4209,840,9674
"33","2016-02-02",4641,3849,842,9332
"34","2016-02-03",4649,3755,822,9226
"35","2016-02-04",4577,3559,859,8995
"36","2016-02-05",4262,4113,543,8918
"37","2016-02-06",2273,3347,218,5838
"38","2016-02-07",1794,3636,196,5626
"39","2016-02-08",1727,4326,165,6218
"40","2016-02-09",1966,3256,262,5484
"41","2016-02-10",2547,4425,318,7290
"42","2016-02-11",4418,3863,629,8910
"43","2016-02-12",4250,3958,565,8773
"44","2016-02-13",2528,3534,173,6235
"45","2016-02-14",2515,3466,317,6298
"46","2016-02-15",4781,4529,714,10024
"47","2016-02-16",4651,4881,827,10359
"48","2016-02-17",4586,4084,696,9366
"49","2016-02-18",4515,4793,733,10041
"50","2016-02-19",4348,4290,612,9250
"51","2016-02-20",2232,3662,175,6069
"52","2016-02-21",2251,3778,299,6328
"53","2016-02-22",5055,4177,934,10166
"54","2016-02-23",4789,4352,811,9952
"55","2016-02-24",4649,3817,930,9396
"56","2016-02-25",4626,3523,943,9092
"57","2016-02-26",4029,3833,603,8465
"58","2016-02-27",2274,3498,190,5962
"59","2016-02-28",2186,3567,340,6093
"60","2016-02-29",4346,3727,685,8758
"61","2016-03-01",2557,3388,336,6281
"62","2016-03-02",4251,3795,850,8896
"63","2016-03-03",4260,3561,714,8535
"64","2016-03-04",4174,3711,545,8430
"65","2016-03-05",2377,3383,175,5935
"66","2016-03-06",2320,3542,352,6214
"67","2016-03-07",4588,4091,741,9420
"68","2016-03-08",4599,3767,761,9127
"69","2016-03-09",4623,3686,777,9086
"70","2016-03-10",4489,3673,647,8809
"71","2016-03-11",4181,3455,475,8111
"72","2016-03-12",2326,3188,128,5642
"73","2016-03-13",2022,3192,233,5447
"74","2016-03-14",4294,3657,684,8635
"75","2016-03-15",4300,3692,727,8719
"76","2016-03-16",4290,4116,698,9104
"77","2016-03-17",4131,4118,699,8948
"78","2016-03-18",4042,3374,577,7993
"79","2016-03-19",2225,2875,199,5299
"80","2016-03-20",2178,2997,320,5495
"81","2016-03-21",4516,3496,716,8728
"82","2016-03-22",4259,4226,691,9176
"83","2016-03-23",4594,2784,695,8073
"84","2016-03-24",5181,3876,663,9720
"85","2016-03-25",4961,3613,551,9125
"86","2016-03-26",2761,3259,175,6195
"87","2016-03-27",2511,3473,356,6340
"88","2016-03-28",5224,4266,788,10278
"89","2016-03-29",5384,4077,794,10255
"90","2016-03-30",5425,3876,785,10086
"91","2016-03-31",5127,3462,735,9324
"92","2016-04-01",4691,3566,522,8779
"93","2016-04-02",2829,3453,384,6666
"94","2016-04-03",2463,3618,425,6506
"95","2016-04-04",5096,4244,693,10033
"96","2016-04-05",4928,3971,685,9584
"97","2016-04-06",5026,4072,662,9760
"98","2016-04-07",4933,3950,681,9564
"99","2016-04-08",4842,3747,537,9126
"100","2016-04-09",2680,3908,167,6755
"101","2016-04-10",2655,4444,251,7350
"102","2016-04-11",5143,4783,653,10579
"103","2016-04-12",4908,4255,610,9773
"104","2016-04-13",3516,3847,259,7622
"105","2016-04-14",5144,5219,515,10878
"106","2016-04-15",4768,3778,568,9114
"107","2016-04-16",2610,3471,132,6213
"108","2016-04-17",2424,3459,242,6125
"109","2016-04-18",5197,4172,643,10012
"110","2016-04-19",5249,3973,786,10008
"111","2016-04-20",5410,4081,839,10330
"112","2016-04-21",5140,3918,709,9767
"113","2016-04-22",4897,3708,557,9162
"114","2016-04-23",3075,3671,230,6976
"115","2016-04-24",2800,3940,326,7066
"116","2016-04-25",5630,4678,750,11058
"117","2016-04-26",5503,4346,782,10631
"118","2016-04-27",5552,4025,774,10351
"119","2016-04-28",5267,4364,726,10357
"120","2016-04-29",4846,3783,549,9178
"121","2016-04-30",2831,3162,181,6174
"122","2016-05-01",2523,3392,301,6216
"123","2016-05-02",5191,4070,741,10002
"124","2016-05-03",5361,4097,618,10076
"125","2016-05-04",4913,4102,662,9677
"126","2016-05-05",2682,3497,319,6498
"127","2016-05-06",3579,3943,320,7842
"128","2016-05-07",2642,3684,257,6583
"129","2016-05-08",2521,6883,301,9705
"130","2016-05-09",4995,6625,747,12367
"131","2016-05-10",5058,4240,708,10006
"132","2016-05-11",5185,6094,776,12055
"133","2016-05-12",5093,4610,683,10386
"134","2016-05-13",4815,4588,539,9942
"135","2016-05-14",2646,3232,139,6017
"136","2016-05-15",2623,4261,248,7132
"137","2016-05-16",5030,4144,801,9975
"138","2016-05-17",5145,4893,747,10785
"139","2016-05-18",5199,3781,894,9874
"140","2016-05-19",5228,4189,860,10277
"141","2016-05-20",5217,4064,639,9920
"142","2016-05-21",2848,3966,226,7040
"143","2016-05-22",2550,3735,355,6640
"144","2016-05-23",5216,5143,715,11074
"145","2016-05-24",5250,4578,700,10528
"146","2016-05-25",5130,4267,777,10174
"147","2016-05-26",5055,4227,667,9949
"148","2016-05-27",4940,4121,565,9626
"149","2016-05-28",2545,3693,160,6398
"150","2016-05-29",2333,3951,305,6589
"151","2016-05-30",5218,4519,860,10597
"152","2016-05-31",5210,4211,750,10171
"153","2016-06-01",4885,4419,775,10079
"154","2016-06-02",4923,3913,672,9508
"155","2016-06-03",4643,3958,555,9156
"156","2016-06-04",2315,3581,166,6062
"157","2016-06-05",2157,3364,195,5716
"158","2016-06-06",2561,3851,246,6658
"159","2016-06-07",4768,4796,634,10198
"160","2016-06-08",5241,4324,620,10185
"161","2016-06-09",5223,4197,618,10038
"162","2016-06-10",4907,2525,519,7951
"163","2016-06-11",2630,2930,192,5752
"164","2016-06-12",2540,4363,251,7154
"165","2016-06-13",4985,4680,542,10207
"166","2016-06-14",4918,4245,631,9794
"167","2016-06-15",4933,4833,652,10418
"168","2016-06-16",4898,4765,613,10276
"169","2016-06-17",4789,4709,604,10102
"170","2016-06-18",2866,3749,206,6821
"171","2016-06-19",2449,3861,297,6607
"172","2016-06-20",5144,4325,725,10194
"173","2016-06-21",5221,4448,574,10243
"174","2016-06-22",5251,4053,591,9895
"175","2016-06-23",5155,4248,673,10076
"176","2016-06-24",5071,3879,547,9497
"177","2016-06-25",2440,3675,142,6257
"178","2016-06-26",2540,3706,248,6494
"179","2016-06-27",5293,4027,654,9974
"180","2016-06-28",5465,4046,878,10389
"181","2016-06-29",5480,4228,814,10522
"182","2016-06-30",5199,4602,727,10528
"183","2016-07-01",5014,3934,562,9510
"184","2016-07-02",2586,3341,141,6068
"185","2016-07-03",2636,3789,246,6671
"186","2016-07-04",5230,4215,578,10023
"187","2016-07-05",5198,4210,653,10061
"188","2016-07-06",5110,4092,712,9914
"189","2016-07-07",4955,4365,804,10124
"190","2016-07-08",5235,4134,736,10105
"191","2016-07-09",2828,3964,201,6993
"192","2016-07-10",2660,4403,300,7363
"193","2016-07-11",5572,5213,671,11456
"194","2016-07-12",5207,4583,648,10438
"195","2016-07-13",5297,4034,720,10051
"196","2016-07-14",4993,4155,620,9768
"197","2016-07-15",4844,4200,485,9529
"198","2016-07-16",2731,3726,145,6602
"199","2016-07-17",2570,4834,308,7712
"200","2016-07-18",5073,4316,754,10143
"201","2016-07-19",5199,4265,726,10190
"202","2016-07-20",5497,4433,726,10656
"203","2016-07-21",5489,4616,709,10814
"204","2016-07-22",5265,4648,554,10467
"205","2016-07-23",2933,5539,139,8611
"206","2016-07-24",2768,7072,318,10158
"207","2016-07-25",5721,4848,665,11234
"208","2016-07-26",5667,4638,732,11037
"209","2016-07-27",5456,4615,720,10791
"210","2016-07-28",5347,4792,753,10892
"211","2016-07-29",4827,4629,552,10008
"212","2016-07-30",2907,4146,210,7263
"213","2016-07-31",2691,3447,277,6415
"214","2016-08-01",4811,4605,584,10000
"215","2016-08-02",4760,4470,573,9803
"216","2016-08-03",5101,5452,633,11186
"217","2016-08-04",5365,5218,651,11234
"218","2016-08-05",5388,4675,587,10650
"219","2016-08-06",2957,4221,231,7409
"220","2016-08-07",2559,4173,308,7040
"221","2016-08-08",5432,5032,679,11143
"222","2016-08-09",5266,4810,573,10649
"223","2016-08-10",5618,4673,718,11009
"224","2016-08-11",5186,4898,607,10691
"225","2016-08-12",4864,4792,524,10180
"226","2016-08-13",2743,4254,207,7204
"227","2016-08-14",2263,3755,249,6267
"228","2016-08-15",2855,4554,241,7650
"229","2016-08-16",5137,4567,628,10332
"230","2016-08-17",5245,4870,629,10744
"231","2016-08-18",4860,4173,589,9622
"232","2016-08-19",4807,3972,535,9314
"233","2016-08-20",2528,3819,174,6521
"234","2016-08-21",2322,6502,268,9092
"235","2016-08-22",5185,5018,630,10833
"236","2016-08-23",4999,4159,607,9765
"237","2016-08-24",5072,4335,689,10096
"238","2016-08-25",4929,4349,698,9976
"239","2016-08-26",4643,4538,475,9656
"240","2016-08-27",2452,3874,151,6477
"241","2016-08-28",2447,3876,255,6578
"242","2016-08-29",5150,5099,733,10982
"243","2016-08-30",5089,4576,753,10418
"244","2016-08-31",5143,4556,854,10553
"245","2016-09-01",5034,4718,367,10119
"246","2016-09-02",4481,8590,442,13513
"247","2016-09-03",2505,4037,138,6680
"248","2016-09-04",2312,4364,279,6955
"249","2016-09-05",4988,4682,756,10426
"250","2016-09-06",4645,4397,803,9845
"251","2016-09-07",4902,4548,825,10275
"252","2016-09-08",4645,4285,785,9715
"253","2016-09-09",4442,4065,588,9095
"254","2016-09-10",2358,3353,171,5882
"255","2016-09-11",2286,3855,263,6404
"256","2016-09-12",4390,4511,692,9593
"257","2016-09-13",3884,4283,559,8726
"258","2016-09-14",1990,4143,242,6375
"259","2016-09-15",1505,3976,160,5641
"260","2016-09-16",1760,3765,170,5695
"261","2016-09-17",2132,3944,138,6214
"262","2016-09-18",2348,3990,270,6608
"263","2016-09-19",4575,4520,631,9726
"264","2016-09-20",4725,4502,717,9944
"265","2016-09-21",4906,4331,847,10084
"266","2016-09-22",4780,4439,729,9948
"267","2016-09-23",4370,4290,465,9125
"268","2016-09-24",2386,3728,238,6352
"269","2016-09-25",2253,3836,298,6387
"270","2016-09-26",4840,4459,751,10050
"271","2016-09-27",4937,4472,745,10154
"272","2016-09-28",4996,4691,692,10379
"273","2016-09-29",4909,4405,679,9993
"274","2016-09-30",4613,4693,566,9872
"275","2016-10-01",2490,4180,198,6868
"276","2016-10-02",2190,4207,357,6754
"277","2016-10-03",2643,4048,374,7065
"278","2016-10-04",4599,4606,716,9921
"279","2016-10-05",4642,4897,739,10278
"280","2016-10-06",4616,4324,626,9566
"281","2016-10-07",4578,4199,457,9234
"282","2016-10-08",2438,3623,133,6194
"283","2016-10-09",2325,3900,347,6572
"284","2016-10-10",5274,4679,751,10704
"285","2016-10-11",5075,7204,809,13088
"286","2016-10-12",4981,4829,748,10558
"287","2016-10-13",4841,4996,575,10412
"288","2016-10-14",4553,4548,474,9575
"289","2016-10-15",2430,3591,152,6173
"290","2016-10-16",2510,3739,260,6509
"291","2016-10-17",4824,4781,624,10229
"292","2016-10-18",4679,4319,657,9655
"293","2016-10-19",4775,4605,631,10011
"294","2016-10-20",4668,4340,589,9597
"295","2016-10-21",4333,4479,416,9228
"296","2016-10-22",2271,3599,135,6005
"297","2016-10-23",2328,4079,258,6665
"298","2016-10-24",4771,4711,577,10059
"299","2016-10-25",4877,4469,817,10163
"300","2016-10-26",4654,4653,702,10009
"301","2016-10-27",4621,4524,557,9702
"302","2016-10-28",4622,4201,520,9343
"303","2016-10-29",2396,3910,160,6466
"304","2016-10-30",2379,4301,409,7089
"305","2016-10-31",4947,4815,568,10330
"306","2016-11-01",4892,4624,679,10195
"307","2016-11-02",4993,4460,614,10067
"308","2016-11-03",4761,4300,616,9677
"309","2016-11-04",4387,4302,395,9084
"310","2016-11-05",2176,3773,149,6098
"311","2016-11-06",2103,3929,289,6321
"312","2016-11-07",4814,4615,568,9997
"313","2016-11-08",4860,4233,560,9653
"314","2016-11-09",4784,3539,556,8879
"315","2016-11-10",4478,4248,461,9187
"316","2016-11-11",4185,3873,430,8488
"317","2016-11-12",2151,3386,156,5693
"318","2016-11-13",2059,3297,210,5566
"319","2016-11-14",4710,4618,580,9908
"320","2016-11-15",4659,4227,502,9388
"321","2016-11-16",4655,6266,507,11428
"322","2016-11-17",4206,4026,594,8826
"323","2016-11-18",4394,4299,469,9162
"324","2016-11-19",2307,3450,141,5898
"325","2016-11-20",2080,3695,189,5964
"326","2016-11-21",4741,4385,589,9715
"327","2016-11-22",4910,4842,639,10391
"328","2016-11-23",5005,4472,637,10114
"329","2016-11-24",4997,4184,592,9773
"330","2016-11-25",4268,4023,516,8807
"331","2016-11-26",2315,3709,158,6182
"332","2016-11-27",2161,4097,220,6478
"333","2016-11-28",4777,4421,632,9830
"334","2016-11-29",4679,4221,583,9483
"335","2016-11-30",4550,4480,655,9685
"336","2016-12-01",4518,4794,623,9935
"337","2016-12-02",4228,4145,546,8919
"338","2016-12-03",2230,3631,125,5986
"339","2016-12-04",2034,3931,260,6225
"340","2016-12-05",4625,5478,510,10613
"341","2016-12-06",4605,5174,650,10429
"342","2016-12-07",4644,5109,638,10391
"343","2016-12-08",4520,5096,623,10239
"344","2016-12-09",4374,4358,442,9174
"345","2016-12-10",2270,4106,122,6498
"346","2016-12-11",1986,4323,210,6519
"347","2016-12-12",4638,5266,464,10368
"348","2016-12-13",4575,4885,543,10003
"349","2016-12-14",4673,4986,549,10208
"350","2016-12-15",4833,4722,540,10095
"351","2016-12-16",4444,4966,452,9862
"352","2016-12-17",2331,4178,153,6662
"353","2016-12-18",2242,4183,207,6632
"354","2016-12-19",4529,4860,580,9969
"355","2016-12-20",4591,4683,709,9983
"356","2016-12-21",4801,4508,685,9994
"357","2016-12-22",4674,6439,582,11695
"358","2016-12-23",4361,5059,469,9889
"359","2016-12-24",2094,4072,137,6303
"360","2016-12-25",1822,4184,237,6243
"361","2016-12-26",4557,4789,638,9984
"362","2016-12-27",4650,4702,637,9989
"363","2016-12-28",4802,5104,594,10500
"364","2016-12-29",4841,4955,716,10512
"365","2016-12-30",4381,5771,615,10767
"366","2016-12-31",3042,6292,200,9534
"367","2017-01-01",3354,8878,453,12685
"368","2017-01-02",5290,5523,52,10865
"369","2017-01-03",5143,4838,744,10725
"370","2017-01-04",5052,4895,673,10620
"371","2017-01-05",4768,4887,688,10343
"372","2017-01-06",4426,4713,427,9566
"373","2017-01-07",2566,4041,159,6766
"374","2017-01-08",2319,4027,218,6564
"375","2017-01-09",5108,4993,664,10765
"376","2017-01-10",4852,5277,558,10687
"377","2017-01-11",5014,5100,632,10746
"378","2017-01-12",4950,4801,586,10337
"379","2017-01-13",4945,4738,581,10264
"380","2017-01-14",2630,4401,240,7271
"381","2017-01-15",2369,4485,281,7135
"382","2017-01-16",5007,6248,619,11874
"383","2017-01-17",4793,6553,632,11978
"384","2017-01-18",4849,5317,611,10777
"385","2017-01-19",4864,4741,599,10204
"386","2017-01-20",4666,4884,437,9987
"387","2017-01-21",2474,4120,203,6797
"388","2017-01-22",2299,4459,261,7019
"389","2017-01-23",4999,5419,880,11298
"390","2017-01-24",4821,5040,896,10757
"391","2017-01-25",4263,4831,798,9892
"392","2017-01-26",3397,4770,473,8640
"393","2017-01-27",1818,4607,222,6647
"394","2017-01-28",1464,4711,208,6383
"395","2017-01-29",1605,3503,175,5283
"396","2017-01-30",2334,4299,301,6934
"397","2017-01-31",4396,4837,614,9847
"398","2017-02-01",4680,4928,825,10433
"399","2017-02-02",4507,5080,643,10230
"400","2017-02-03",4324,4836,469,9629
"401","2017-02-04",2359,6521,157,9037
"402","2017-02-05",2205,4131,248,6584
"403","2017-02-06",4582,4760,608,9950
"404","2017-02-07",4543,4771,587,9901
"405","2017-02-08",4771,3981,732,9484
"406","2017-02-09",4868,4305,646,9819
"407","2017-02-10",4654,5028,528,10210
"408","2017-02-11",2527,4347,201,7075
"409","2017-02-12",2159,4187,252,6598
"410","2017-02-13",4463,4701,547,9711
"411","2017-02-14",4343,4723,684,9750
"412","2017-02-15",4678,4462,631,9771
"413","2017-02-16",4345,4761,540,9646
"414","2017-02-17",4216,5170,509,9895
"415","2017-02-18",2315,4678,168,7161
"416","2017-02-19",2112,4163,239,6514
"417","2017-02-20",4739,5076,661,10476
"418","2017-02-21",4462,4914,668,10044
"419","2017-02-22",4545,5345,690,10580
"420","2017-02-23",4446,5317,676,10439
"421","2017-02-24",4229,4773,488,9490
"422","2017-02-25",2114,4170,173,6457
"423","2017-02-26",2140,5021,291,7452
"424","2017-02-27",4432,9134,690,14256
"425","2017-02-28",4141,5395,775,10311
"426","2017-03-01",2550,4785,394,7729
"427","2017-03-02",4369,4784,884,10037
"428","2017-03-03",4098,4481,583,9162
"429","2017-03-04",2181,4303,207,6691
"430","2017-03-05",2056,4142,272,6470
"431","2017-03-06",4726,4803,729,10258
"432","2017-03-07",4725,4531,723,9979
"433","2017-03-08",4705,4566,795,10066
"434","2017-03-09",4590,5119,775,10484
"435","2017-03-10",3821,2864,455,7140
"436","2017-03-11",2149,3927,151,6227
"437","2017-03-12",2204,4187,247,6638
"438","2017-03-13",4379,5123,613,10115
"439","2017-03-14",4424,4938,717,10079
"440","2017-03-15",4497,4604,784,9885
"441","2017-03-16",4281,4595,807,9683
"442","2017-03-17",4083,4452,559,9094
"443","2017-03-18",2205,3817,182,6204
"444","2017-03-19",2136,4087,369,6592
"445","2017-03-20",4584,4796,787,10167
"446","2017-03-21",4681,4827,745,10253
"447","2017-03-22",4612,6232,807,11651
"448","2017-03-23",4553,5058,714,10325
"449","2017-03-24",4136,4407,726,9269
"450","2017-03-25",2146,4098,229,6473
"451","2017-03-26",2069,4431,278,6778
"452","2017-03-27",4682,5199,881,10762
"453","2017-03-28",4618,4489,771,9878
"454","2017-03-29",4661,4660,746,10067
"455","2017-03-30",4389,4324,749,9462
"456","2017-03-31",4302,4249,534,9085
"457","2017-04-01",2153,4113,135,6401
"458","2017-04-02",2045,4110,304,6459
"459","2017-04-03",4410,5110,813,10333
"460","2017-04-04",4383,4857,817,10057
"461","2017-04-05",4482,4657,732,9871
"462","2017-04-06",4575,4814,664,10053
"463","2017-04-07",4133,5229,481,9843
"464","2017-04-08",2268,4220,159,6647
"465","2017-04-09",2103,4046,294,6443
"466","2017-04-10",4372,4760,681,9813
"467","2017-04-11",4600,4599,682,9881
"468","2017-04-12",4658,4707,738,10103
"469","2017-04-13",4553,4841,679,10073
"470","2017-04-14",4458,4731,549,9738
"471","2017-04-15",2359,4573,220,7152
"472","2017-04-16",2255,4120,293,6668
"473","2017-04-17",4749,5171,676,10596
"474","2017-04-18",4959,5168,746,10873
"475","2017-04-19",4689,5178,749,10616
"476","2017-04-20",4556,4813,853,10222
"477","2017-04-21",4403,4850,699,9952
"478","2017-04-22",2209,3999,170,6378
"479","2017-04-23",2160,3738,385,6283
"480","2017-04-24",4814,5332,713,10859
"481","2017-04-25",4726,5026,708,10460
"482","2017-04-26",4654,4531,824,10009
"483","2017-04-27",4580,4753,912,10245
"484","2017-04-28",4417,4661,662,9740
"485","2017-04-29",2361,4048,163,6572
"486","2017-04-30",2163,4406,296,6865
"487","2017-05-01",3584,4817,586,8987
"488","2017-05-02",4219,4868,608,9695
"489","2017-05-03",2685,4374,293,7352
"490","2017-05-04",3771,4555,573,8899
"491","2017-05-05",2204,4639,334,7177
"492","2017-05-06",2337,5061,247,7645
"493","2017-05-07",2256,4575,396,7227
"494","2017-05-08",4880,5112,714,10706
"495","2017-05-09",3301,3658,296,7255
"496","2017-05-10",4441,4320,582,9343
"497","2017-05-11",4449,4466,550,9465
"498","2017-05-12",4346,4739,565,9650
"499","2017-05-13",2362,3928,155,6445
"500","2017-05-14",2096,4186,253,6535
"501","2017-05-15",4692,4792,601,10085
"502","2017-05-16",4852,4915,694,10461
"503","2017-05-17",4728,4745,753,10226
"504","2017-05-18",4517,4651,686,9854
"505","2017-05-19",4384,5113,593,10090
"506","2017-05-20",2584,4128,203,6915
"507","2017-05-21",2373,3996,314,6683
"508","2017-05-22",5041,4457,692,10190
"509","2017-05-23",4897,4522,696,10115
"510","2017-05-24",4604,5296,745,10645
"511","2017-05-25",4596,5208,664,10468
"512","2017-05-26",4143,4020,528,8691
"513","2017-05-27",2106,3468,243,5817
"514","2017-05-28",1976,4025,333,6334
"515","2017-05-29",4848,4763,753,10364
"516","2017-05-30",4899,5341,901,11141
"517","2017-05-31",4743,4720,786,10249
"518","2017-06-01",4611,4508,790,9909
"519","2017-06-02",4287,4489,630,9406
"520","2017-06-03",2338,3861,212,6411
"521","2017-06-04",2093,3952,298,6343
"522","2017-06-05",4163,4791,786,9740
"523","2017-06-06",2440,4024,347,6811
"524","2017-06-07",4487,4665,818,9970
"525","2017-06-08",4376,4530,801,9707
"526","2017-06-09",4387,4757,539,9683
"527","2017-06-10",2246,3954,137,6337
"528","2017-06-11",2132,3951,266,6349
"529","2017-06-12",4541,4900,659,10100
"530","2017-06-13",4615,4927,694,10236
"531","2017-06-14",4571,4577,667,9815
"532","2017-06-15",4568,4492,753,9813
"533","2017-06-16",4464,4832,635,9931
"534","2017-06-17",2376,3389,240,6005
"535","2017-06-18",2192,3791,291,6274
"536","2017-06-19",5066,4621,730,10417
"537","2017-06-20",4919,4686,807,10412
"538","2017-06-21",5041,4594,1048,10683
"539","2017-06-22",5041,4159,777,9977
"540","2017-06-23",4663,4270,659,9592
"541","2017-06-24",2243,3746,173,6162
"542","2017-06-25",2127,3989,219,6335
"543","2017-06-26",4447,4481,622,9550
"544","2017-06-27",4568,4186,757,9511
"545","2017-06-28",4738,4427,867,10032
"546","2017-06-29",4756,4321,779,9856
"547","2017-06-30",4691,4583,565,9839
"548","2017-07-01",2502,3615,168,6285
"549","2017-07-02",2235,3448,227,5910
"550","2017-07-03",4542,4067,668,9277
"551","2017-07-04",4722,3960,643,9325
"552","2017-07-05",5011,4667,655,10333
"553","2017-07-06",4767,4475,661,9903
"554","2017-07-07",4412,4345,471,9228
"555","2017-07-08",2274,3775,148,6197
"556","2017-07-09",2115,3697,255,6067
"557","2017-07-10",4807,4324,639,9770
"558","2017-07-11",4926,4769,759,10454
"559","2017-07-12",5353,4747,873,10973
"560","2017-07-13",4995,4594,697,10286
"561","2017-07-14",4808,4591,665,10064
"562","2017-07-15",2324,3660,212,6196
"563","2017-07-16",2087,3879,307,6273
"564","2017-07-17",4750,4672,640,10062
"565","2017-07-18",4799,4326,813,9938
"566","2017-07-19",5105,4730,913,10748
"567","2017-07-20",5193,4653,821,10667
"568","2017-07-21",4969,4863,608,10440
"569","2017-07-22",2517,4348,194,7059
"570","2017-07-23",2261,4240,239,6740
"571","2017-07-24",4873,4748,781,10402
"572","2017-07-25",4985,4808,780,10573
"573","2017-07-26",4914,5122,988,11024
"574","2017-07-27",4712,5030,837,10579
"575","2017-07-28",4400,4616,594,9610
"576","2017-07-29",2196,4340,185,6721
"577","2017-07-30",2035,4057,286,6378
"578","2017-07-31",4255,4777,636,9668
"579","2017-08-01",4338,4942,681,9961
"580","2017-08-02",4515,4958,632,10105
"581","2017-08-03",4465,4665,727,9857
"582","2017-08-04",4415,4781,522,9718
"583","2017-08-05",2323,4409,170,6902
"584","2017-08-06",2118,4299,268,6685
"585","2017-08-07",4818,5041,688,10547
"586","2017-08-08",4651,5073,782,10506
"587","2017-08-09",4513,7996,1039,13548
"588","2017-08-10",4420,4623,1024,10067
"589","2017-08-11",4442,4245,649,9336
"590","2017-08-12",2096,3832,221,6149
"591","2017-08-13",1866,3831,254,5951
"592","2017-08-14",3912,4298,657,8867
"593","2017-08-15",2477,3821,306,6604
"594","2017-08-16",4499,4146,714,9359
"595","2017-08-17",4446,4490,811,9747
"596","2017-08-18",4173,4472,585,9230
"597","2017-08-19",2249,4633,215,7097
"598","2017-08-20",2178,4071,309,6558
"599","2017-08-21",4518,4868,859,10245
"600","2017-08-22",4542,4774,826,10142
"601","2017-08-23",4589,4460,738,9787
"602","2017-08-24",4513,4199,759,9471
"603","2017-08-25",4000,4223,512,8735
"604","2017-08-26",2121,4364,146,6631
"605","2017-08-27",2049,4664,271,6984
"606","2017-08-28",4348,4883,715,9946
"607","2017-08-29",4625,4659,788,10072
"608","2017-08-30",4733,5023,833,10589
"609","2017-08-31",4775,4622,799,10196
"610","2017-09-01",4337,4561,564,9462
"611","2017-09-02",1794,4150,192,6136
"612","2017-09-03",1782,4095,292,6169
"613","2017-09-04",4655,4812,814,10281
"614","2017-09-05",4586,4593,706,9885
"615","2017-09-06",4649,4359,687,9695
"616","2017-09-07",4628,3936,766,9330
"617","2017-09-08",4412,4144,611,9167
"618","2017-09-09",2105,3963,223,6291
"619","2017-09-10",1950,4189,268,6407
"620","2017-09-11",4550,4642,677,9869
"621","2017-09-12",4649,4303,670,9622
"622","2017-09-13",4690,4457,664,9811
"623","2017-09-14",4507,4568,669,9744
"624","2017-09-15",4342,4630,581,9553
"625","2017-09-16",2246,3665,176,6087
"626","2017-09-17",2017,4091,277,6385
"627","2017-09-18",4684,4791,846,10321
"628","2017-09-19",4578,5177,716,10471
"629","2017-09-20",4687,4929,876,10492
"630","2017-09-21",4598,5074,795,10467
"631","2017-09-22",4335,7299,637,12271
"632","2017-09-23",2196,3984,214,6394
"633","2017-09-24",2045,4524,325,6894
"634","2017-09-25",4491,4839,848,10178
"635","2017-09-26",4378,4672,834,9884
"636","2017-09-27",4384,4461,822,9667
"637","2017-09-28",4063,4337,900,9300
"638","2017-09-29",3896,4335,619,8850
"639","2017-09-30",2118,4597,214,6929
"640","2017-10-01",1797,4252,205,6254
"641","2017-10-02",2582,4213,284,7079
"642","2017-10-03",1764,4003,223,5990
"643","2017-10-04",1364,3879,163,5406
"644","2017-10-05",1652,3634,194,5480
"645","2017-10-06",2028,4064,216,6308
"646","2017-10-07",1855,3896,235,5986
"647","2017-10-08",1771,4049,279,6099
"648","2017-10-09",2482,3877,393,6752
"649","2017-10-10",4169,4592,842,9603
"650","2017-10-11",4429,6793,731,11953
"651","2017-10-12",4552,6553,737,11842
"652","2017-10-13",4335,5102,659,10096
"653","2017-10-14",2251,3781,215,6247
"654","2017-10-15",2039,3755,320,6114
"655","2017-10-16",4488,4311,794,9593
"656","2017-10-17",4704,4321,710,9735
"657","2017-10-18",4461,4511,777,9749
"658","2017-10-19",4456,4398,607,9461
"659","2017-10-20",3816,4465,589,8870
"660","2017-10-21",2021,4190,212,6423
"661","2017-10-22",2047,4388,294,6729
"662","2017-10-23",4833,4536,758,10127
"663","2017-10-24",4512,4421,888,9821
"664","2017-10-25",4531,4299,838,9668
"665","2017-10-26",4579,3440,814,8833
"666","2017-10-27",4192,3890,599,8681
"667","2017-10-28",2272,3810,219,6301
"668","2017-10-29",2137,4034,358,6529
"669","2017-10-30",4819,4712,822,10353
"670","2017-10-31",4738,4361,850,9949
"671","2017-11-01",4609,4733,805,10147
"672","2017-11-02",4478,4387,693,9558
"673","2017-11-03",4297,4765,571,9633
"674","2017-11-04",2177,4783,185,7145
"675","2017-11-05",2098,4677,243,7018
"676","2017-11-06",4422,4796,784,10002
"677","2017-11-07",4504,4876,700,10080
"678","2017-11-08",4639,4623,757,10019
"679","2017-11-09",4311,4367,804,9482
"680","2017-11-10",4329,4788,575,9692
"681","2017-11-11",2124,4222,182,6528
"682","2017-11-12",2001,4130,291,6422
"683","2017-11-13",4671,4193,633,9497
"684","2017-11-14",4672,4301,764,9737
"685","2017-11-15",4451,4002,683,9136
"686","2017-11-16",4480,4198,658,9336
"687","2017-11-17",4326,4411,566,9303
"688","2017-11-18",2305,4244,203,6752
"689","2017-11-19",2125,4216,324,6665
"690","2017-11-20",4760,4777,724,10261
"691","2017-11-21",4556,4634,777,9967
"692","2017-11-22",4686,4523,883,10092
"693","2017-11-23",4395,3892,704,8991
"694","2017-11-24",4476,4334,608,9418
"695","2017-11-25",2182,3526,183,5891
"696","2017-11-26",1911,3959,295,6165
"697","2017-11-27",4472,4014,707,9193
"698","2017-11-28",4391,4541,664,9596
"699","2017-11-29",4534,4205,829,9568
"700","2017-11-30",4475,3599,845,8919
"701","2017-12-01",4251,3617,729,8597
"702","2017-12-02",2138,2877,242,5257
"703","2017-12-03",1999,3433,298,5730
"704","2017-12-04",4558,4855,794,10207
"705","2017-12-05",4618,4939,691,10248
"706","2017-12-06",4643,4897,765,10305
"707","2017-12-07",4394,4679,557,9630
"708","2017-12-08",4327,3828,533,8688
"709","2017-12-09",1981,4469,195,6645
"710","2017-12-10",1874,4309,455,6638
"711","2017-12-11",4756,5017,906,10679
"712","2017-12-12",4738,4646,883,10267
"713","2017-12-13",5052,4281,1003,10336
"714","2017-12-14",4805,3913,833,9551
"715","2017-12-15",4445,4030,636,9111
"716","2017-12-16",2212,4434,209,6855
"717","2017-12-17",2011,6579,323,8913
"718","2017-12-18",4477,4422,683,9582
"719","2017-12-19",4573,4608,687,9868
"720","2017-12-20",4537,5111,879,10527
"721","2017-12-21",4321,3489,715,8525
"722","2017-12-22",4203,4279,650,9132
"723","2017-12-23",2201,4196,179,6576
"724","2017-12-24",1816,4022,173,6011
"725","2017-12-25",2129,4037,284,6450
"726","2017-12-26",4553,4953,955,10461
"727","2017-12-27",4719,5115,914,10748
"728","2017-12-28",4601,4844,805,10250
"729","2017-12-29",4295,5022,683,10000
"730","2017-12-30",2534,5369,220,8123
"731","2017-12-31",2765,6992,365,10122
"732","2018-01-01",3640,8255,503,12398
"733","2018-01-02",5314,5382,892,11588
"734","2018-01-03",5009,7885,694,13588
"735","2018-01-04",4880,7336,848,13064
"736","2018-01-05",4664,5421,509,10594
"737","2018-01-06",2383,4832,162,7377
"738","2018-01-07",2298,4866,348,7512
"739","2018-01-08",4892,5401,773,11066
"740","2018-01-09",5110,5146,657,10913
"741","2018-01-10",4996,5220,760,10976
"742","2018-01-11",4965,4234,712,9911
"743","2018-01-12",4981,4807,623,10411
"744","2018-01-13",2506,3871,181,6558
"745","2018-01-14",2324,5137,355,7816
"746","2018-01-15",4839,5770,645,11254
"747","2018-01-16",3886,5240,821,9947
"748","2018-01-17",5295,4828,778,10901
"749","2018-01-18",5244,4421,833,10498
"750","2018-01-19",4997,4870,618,10485
"751","2018-01-20",2541,2088,154,4783
"752","2018-01-21",3263,4491,233,7987
"753","2018-01-22",5228,4867,763,10858
"754","2018-01-23",5470,4619,1071,11160
"755","2018-01-24",5335,4933,949,11217
"756","2018-01-25",5272,5034,914,11220
"757","2018-01-26",5033,4517,676,10226
"758","2018-01-27",2724,3883,223,6830
"759","2018-01-28",2490,4187,252,6929
"760","2018-01-29",5159,4086,876,10121
"761","2018-01-30",5098,4191,915,10204
"762","2018-01-31",4929,4138,832,9899
"763","2018-02-01",4713,4273,691,9677
"764","2018-02-02",4792,3806,559,9157
"765","2018-02-03",2886,3858,247,6991
"766","2018-02-04",2804,3582,279,6665
"767","2018-02-05",5223,6973,652,12848
"768","2018-02-06",5461,4508,740,10709
"769","2018-02-07",5297,4133,727,10157
"770","2018-02-08",5247,4221,712,10180
"771","2018-02-09",4860,3787,508,9155
"772","2018-02-10",2845,2138,190,5173
"773","2018-02-11",2174,3563,213,5950
"774","2018-02-12",4848,4109,741,9698
"775","2018-02-13",5002,4079,680,9761
"776","2018-02-14",4396,3797,532,8725
"777","2018-02-15",2202,3826,213,6241
"778","2018-02-16",1873,3916,221,6010
"779","2018-02-17",1726,3315,191,5232
"780","2018-02-18",2297,4087,270,6654
"781","2018-02-19",3233,3759,560,7552
"782","2018-02-20",2835,3990,678,7503
"783","2018-02-21",4957,3725,641,9323
"784","2018-02-22",4889,2441,633,7963
"785","2018-02-23",4951,4001,536,9488
"786","2018-02-24",2657,3198,163,6018
"787","2018-02-25",2335,2771,255,5361
"788","2018-02-26",4870,3867,659,9396
"789","2018-02-27",4986,3966,771,9723
"790","2018-02-28",4851,4337,640,9828
"791","2018-03-01",3189,3961,347,7497
"792","2018-03-02",5111,3796,643,9550
"793","2018-03-03",2870,3502,186,6558
"794","2018-03-04",2668,4372,209,7249
"795","2018-03-05",4947,3214,697,8858
"796","2018-03-06",4697,3993,718,9408
"797","2018-03-07",5072,4194,599,9865
"798","2018-03-08",4973,3728,616,9317
"799","2018-03-09",4706,3665,536,8907
"800","2018-03-10",2756,3703,200,6659
"801","2018-03-11",2616,3579,299,6494
"802","2018-03-12",5195,4525,693,10413
"803","2018-03-13",5062,4018,752,9832
"804","2018-03-14",5096,4026,718,9840
"805","2018-03-15",4957,3966,771,9694
"806","2018-03-16",4702,4193,500,9395
"807","2018-03-17",1462,4098,187,5747
"808","2018-03-18",2134,3673,410,6217
"809","2018-03-19",5194,4445,593,10232
"810","2018-03-20",5553,4629,986,11168
"811","2018-03-21",5570,4296,772,10638
"812","2018-03-22",5295,3894,736,9925
"813","2018-03-23",4975,4059,598,9632
"814","2018-03-24",2629,4025,237,6891
"815","2018-03-25",2886,4714,371,7971
"816","2018-03-26",5939,5547,831,12317
"817","2018-03-27",5871,4142,912,10925
"818","2018-03-28",5550,4649,858,11057
"819","2018-03-29",5456,4467,892,10815
"820","2018-03-30",4996,4094,741,9831
"821","2018-03-31",2911,3993,217,7121
"822","2018-04-01",2655,3834,314,6803
"823","2018-04-02",4927,4523,740,10190
"824","2018-04-03",5238,4127,752,10117
"825","2018-04-04",5398,3814,838,10050
"826","2018-04-05",5503,3497,760,9760
"827","2018-04-06",5445,3382,695,9522
"828","2018-04-07",3159,3458,218,6835
"829","2018-04-08",2798,3432,362,6592
"830","2018-04-09",5384,4296,712,10392
"831","2018-04-10",5094,3783,684,9561
"832","2018-04-11",5336,3486,677,9499
"833","2018-04-12",5031,3572,640,9243
"834","2018-04-13",5010,3579,575,9164
"835","2018-04-14",3001,2741,192,5934
"836","2018-04-15",2731,3145,342,6218
"837","2018-04-16",5165,3950,767,9882
"838","2018-04-17",4886,4087,924,9897
"839","2018-04-18",5399,4456,839,10694
"840","2018-04-19",5426,4427,834,10687
"841","2018-04-20",5339,4284,583,10206
"842","2018-04-21",2946,3745,202,6893
"843","2018-04-22",2817,3783,262,6862
"844","2018-04-23",5356,4545,722,10623
"845","2018-04-24",5252,4475,786,10513
"846","2018-04-25",5211,4490,946,10647
"847","2018-04-26",4751,3824,823,9398
"848","2018-04-27",4753,3606,489,8848
"849","2018-04-28",2851,3786,245,6882
"850","2018-04-29",2676,3183,251,6110
"851","2018-04-30",5076,4039,717,9832
"852","2018-05-01",3990,4002,455,8447
"853","2018-05-02",5206,3374,652,9232
"854","2018-05-03",5255,3173,764,9192
"855","2018-05-04",4888,3344,582,8814
"856","2018-05-05",2515,3139,191,5845
"857","2018-05-06",2535,2530,189,5254
"858","2018-05-07",3389,2741,351,6481
"859","2018-05-08",5246,4096,921,10263
"860","2018-05-09",5442,2747,861,9050
"861","2018-05-10",5361,4047,927,10335
"862","2018-05-11",5034,3770,827,9631
"863","2018-05-12",2896,2373,199,5468
"864","2018-05-13",2347,2079,257,4683
"865","2018-05-14",2598,3237,721,6556
"866","2018-05-15",3816,3549,691,8056
"867","2018-05-16",5627,3072,772,9471
"868","2018-05-17",5210,2994,626,8830
"869","2018-05-18",5013,2886,535,8434
"870","2018-05-19",2818,2568,133,5519
"871","2018-05-20",2569,2353,321,5243
"872","2018-05-21",4764,3085,585,8434
"873","2018-05-22",3011,2545,341,5897
"874","2018-05-23",5009,2892,649,8550
"875","2018-05-24",4953,3167,789,8909
"876","2018-05-25",2395,3658,597,6650
"877","2018-05-26",2296,3310,196,5802
"878","2018-05-27",3072,3797,301,7170
"879","2018-05-28",5605,4037,764,10406
"880","2018-05-29",5224,4029,672,9925
"881","2018-05-30",5196,3502,753,9451
"882","2018-05-31",5207,2769,681,8657
"883","2018-06-01",5203,3157,603,8963
"884","2018-06-02",3025,2259,195,5479
"885","2018-06-03",2822,2628,226,5676
"886","2018-06-04",5187,3864,794,9845
"887","2018-06-05",5234,3441,736,9411
"888","2018-06-06",3326,3107,330,6763
"889","2018-06-07",5439,3277,836,9552
"890","2018-06-08",5091,2729,593,8413
"891","2018-06-09",2885,2293,162,5340
"892","2018-06-10",2790,2711,232,5733
"893","2018-06-11",5260,3200,692,9152
"894","2018-06-12",4912,2687,481,8080
"895","2018-06-13",3394,1510,209,5113
"896","2018-06-14",4986,2523,576,8085
"897","2018-06-15",4669,3462,454,8585
"898","2018-06-16",3388,3434,150,6972
"899","2018-06-17",3320,2571,234,6125
"900","2018-06-18",5958,4045,663,10666
"901","2018-06-19",5622,3560,655,9837
"902","2018-06-20",6315,3623,751,10689
"903","2018-06-21",6703,3303,666,10672
"904","2018-06-22",6320,2910,658,9888
"905","2018-06-23",3695,2378,220,6293
"906","2018-06-24",3646,2866,320,6832
"907","2018-06-25",6209,3499,680,10388
"908","2018-06-26",6476,3215,687,10378
"909","2018-06-27",6004,3647,807,10458
"910","2018-06-28",5423,3079,826,9328
"911","2018-06-29",5564,3664,568,9796
"912","2018-06-30",3444,3702,185,7331
"913","2018-07-01",3116,3112,298,6526
"914","2018-07-02",5689,3680,774,10143
"915","2018-07-03",5669,4050,772,10491
"916","2018-07-04",5951,4044,832,10827
"917","2018-07-05",5916,3723,679,10318
"918","2018-07-06",5741,3434,470,9645
"919","2018-07-07",4059,3153,157,7369
"920","2018-07-08",3400,3135,240,6775
"921","2018-07-09",5651,3270,740,9661
"922","2018-07-10",5772,3846,876,10494
"923","2018-07-11",5749,3527,960,10236
"924","2018-07-12",6312,3320,767,10399
"925","2018-07-13",6062,3304,587,9953
"926","2018-07-14",3576,2426,246,6248
"927","2018-07-15",1800,2220,298,4318
"928","2018-07-16",5396,4199,741,10336
"929","2018-07-17",6972,4869,762,12603
"930","2018-07-18",6723,4368,847,11938
"931","2018-07-19",6694,3982,740,11416
"932","2018-07-20",6738,4653,532,11923
"933","2018-07-21",4260,3908,211,8379
"934","2018-07-22",4062,4163,343,8568
"935","2018-07-23",7589,4921,819,13329
"936","2018-07-24",7443,4212,980,12635
"937","2018-07-25",7337,4716,881,12934
"938","2018-07-26",7374,4287,898,12559
"939","2018-07-27",6755,4918,598,12271
"940","2018-07-28",3632,3408,190,7230
"941","2018-07-29",3408,3196,381,6985
"942","2018-07-30",6192,3883,814,10889
"943","2018-07-31",6642,3568,719,10929
"944","2018-08-01",6774,4638,708,12120
"945","2018-08-02",6147,3421,788,10356
"946","2018-08-03",6038,4114,608,10760
"947","2018-08-04",3522,2571,202,6295
"948","2018-08-05",3323,3022,258,6603
"949","2018-08-06",5811,3095,727,9633
"950","2018-08-07",6052,2556,678,9286
"951","2018-08-08",6048,2212,734,8994
"952","2018-08-09",5823,3174,677,9674
"953","2018-08-10",6489,2618,568,9675
"954","2018-08-11",3071,2868,196,6135
"955","2018-08-12",2913,2639,198,5750
"956","2018-08-13",5991,3273,653,9917
"957","2018-08-14",5746,3528,672,9946
"958","2018-08-15",3652,2447,350,6449
"959","2018-08-16",5842,3812,574,10228
"960","2018-08-17",5315,5045,439,10799
"961","2018-08-18",3073,3737,183,6993
"962","2018-08-19",3002,3227,270,6499
"963","2018-08-20",5538,4990,626,11154
"964","2018-08-21",5522,4750,642,10914
"965","2018-08-22",5572,6479,671,12722
"966","2018-08-23",5378,3598,641,9617
"967","2018-08-24",4895,4411,438,9744
"968","2018-08-25",2548,4184,143,6875
"969","2018-08-26",2507,3916,280,6703
"970","2018-08-27",5062,4653,697,10412
"971","2018-08-28",4948,4464,631,10043
"972","2018-08-29",2057,4093,796,6946
"973","2018-08-30",3996,4135,577,8708
"974","2018-08-31",4948,3690,523,9161
"975","2018-09-01",2516,3468,117,6101
"976","2018-09-02",2412,3586,220,6218
"977","2018-09-03",5043,4356,632,10031
"978","2018-09-04",5112,3751,816,9679
"979","2018-09-05",2282,3328,681,6291
"980","2018-09-06",4022,3426,708,8156
"981","2018-09-07",5103,3353,549,9005
"982","2018-09-08",2934,3077,206,6217
"983","2018-09-09",2829,3130,342,6301
"984","2018-09-10",5830,3593,920,10343
"985","2018-09-11",5248,3395,733,9376
"986","2018-09-12",5450,3169,685,9304
"987","2018-09-13",5392,3600,711,9703
"988","2018-09-14",5230,4145,517,9892
"989","2018-09-15",2752,3807,143,6702
"990","2018-09-16",2744,3975,240,6959
"991","2018-09-17",5454,5146,651,11251
"992","2018-09-18",5445,4177,627,10249
"993","2018-09-19",5343,4297,568,10208
"994","2018-09-20",5329,4559,649,10537
"995","2018-09-21",5046,4379,522,9947
"996","2018-09-22",2753,4577,247,7577
"997","2018-09-23",2218,4500,195,6913
"998","2018-09-24",2083,4424,173,6680
"999","2018-09-25",2265,3720,158,6143
"1000","2018-09-26",3073,3530,281,6884
"1001","2018-09-27",5112,1596,671,7379
"1002","2018-09-28",5211,2110,478,7799
"1003","2018-09-29",2938,1874,180,4992
"1004","2018-09-30",2802,2027,313,5142
"1005","2018-10-01",5658,3418,752,9828
"1006","2018-10-02",5535,4645,692,10872
"1007","2018-10-03",3466,3204,275,6945
"1008","2018-10-04",5308,3108,612,9028
"1009","2018-10-05",5402,4222,553,10177
"1010","2018-10-06",2899,3790,146,6835
"1011","2018-10-07",1355,3767,301,5423
"1012","2018-10-08",3917,5287,667,9871
"1013","2018-10-09",3091,4153,294,7538
"1014","2018-10-10",5690,5345,689,11724
"1015","2018-10-11",5640,4579,705,10924
"1016","2018-10-12",5540,6779,617,12936
"1017","2018-10-13",2951,5351,280,8582
"1018","2018-10-14",2703,4230,388,7321
"1019","2018-10-15",5288,4564,739,10591
"1020","2018-10-16",2484,4461,690,7635
"1021","2018-10-17",4350,4267,625,9242
"1022","2018-10-18",5432,4657,657,10746
"1023","2018-10-19",5461,5755,663,11879
"1024","2018-10-20",3035,4291,188,7514
"1025","2018-10-21",2700,3975,298,6973
"1026","2018-10-22",5527,4736,605,10868
"1027","2018-10-23",5656,4268,656,10580
"1028","2018-10-24",5464,3799,739,10002
"1029","2018-10-25",5341,4065,733,10139
"1030","2018-10-26",5157,4492,555,10204
"1031","2018-10-27",2743,3643,185,6571
"1032","2018-10-28",2772,3573,334,6679
"1033","2018-10-29",5558,4629,714,10901
"1034","2018-10-30",5642,4090,788,10520
"1035","2018-10-31",5549,4290,785,10624
"1036","2018-11-01",5454,4274,739,10467
"1037","2018-11-02",5180,3878,584,9642
"1038","2018-11-03",2792,3646,201,6639
"1039","2018-11-04",2693,4355,329,7377
"1040","2018-11-05",5616,4749,784,11149
"1041","2018-11-06",5761,4731,746,11238
"1042","2018-11-07",6127,4349,851,11327
"1043","2018-11-08",5758,4273,667,10698
"1044","2018-11-09",5481,4323,541,10345
"1045","2018-11-10",2878,3740,180,6798
"1046","2018-11-11",2685,3869,318,6872
"1047","2018-11-12",5564,4458,720,10742
"1048","2018-11-13",5487,4432,812,10731
"1049","2018-11-14",5552,3940,695,10187
"1050","2018-11-15",5163,4071,631,9865
"1051","2018-11-16",5052,4305,487,9844
"1052","2018-11-17",2707,4073,169,6949
"1053","2018-11-18",2600,4245,265,7110
"1054","2018-11-19",5587,4565,695,10847
"1055","2018-11-20",5584,4831,647,11062
"1056","2018-11-21",5720,4607,583,10910
"1057","2018-11-22",5826,4806,754,11386
"1058","2018-11-23",5406,4472,688,10566
"1059","2018-11-24",2803,4125,171,7099
"1060","2018-11-25",2423,3884,242,6549
"1061","2018-11-26",5474,4898,626,10998
"1062","2018-11-27",5609,4919,607,11135
"1063","2018-11-28",5889,4607,717,11213
"1064","2018-11-29",5459,4699,795,10953
"1065","2018-11-30",5582,4667,573,10822
"1066","2018-12-01",2750,4375,179,7304
"1067","2018-12-02",2705,3656,283,6644
"1068","2018-12-03",5509,5533,706,11748
"1069","2018-12-04",5846,5589,749,12184
"1070","2018-12-05",5554,5068,706,11328
"1071","2018-12-06",5488,5319,751,11558
"1072","2018-12-07",5356,5327,716,11399
"1073","2018-12-08",2730,4815,275,7820
"1074","2018-12-09",2530,4653,299,7482
"1075","2018-12-10",5504,5661,804,11969
"1076","2018-12-11",5392,5171,728,11291
"1077","2018-12-12",5562,4485,865,10912
"1078","2018-12-13",5277,4530,631,10438
"1079","2018-12-14",5047,4877,681,10605
"1080","2018-12-15",2585,3651,233,6469
"1081","2018-12-16",2405,4991,301,7697
"1082","2018-12-17",4258,5445,626,10329
"1083","2018-12-18",4757,5496,674,10927
"1084","2018-12-19",4745,5001,654,10400
"1085","2018-12-20",4696,5125,753,10574
"1086","2018-12-21",4665,4773,534,9972
"1087","2018-12-22",2563,4394,169,7126
"1088","2018-12-23",2255,4423,274,6952
"1089","2018-12-24",4314,5021,525,9860
"1090","2018-12-25",2220,4223,299,6742
"1091","2018-12-26",4944,4439,694,10077
"1092","2018-12-27",5264,4939,786,10989
"1093","2018-12-28",5248,5602,658,11508
"1094","2018-12-29",2614,3575,227,6416
"1095","2018-12-30",2402,5007,325,7734
"1096","2018-12-31",5238,7170,589,12997
"1097","2019-01-01",3649,7724,582,11955
"1098","2019-01-02",5810,6119,969,12898
"1099","2019-01-03",5444,5614,788,11846
"1100","2019-01-04",5116,5753,724,11593
"1101","2019-01-05",2630,4449,194,7273
"1102","2019-01-06",2436,3774,327,6537
"1103","2019-01-07",5080,4532,762,10374
"1104","2019-01-08",5479,4993,741,11213
"1105","2019-01-09",5679,5239,683,11601
"1106","2019-01-10",5393,4635,671,10699
"1107","2019-01-11",5225,5863,715,11803
"1108","2019-01-12",2735,4753,220,7708
"1109","2019-01-13",2455,4666,296,7417
"1110","2019-01-14",5966,5828,829,12623
"1111","2019-01-15",6187,5458,784,12429
"1112","2019-01-16",5812,6067,756,12635
"1113","2019-01-17",5572,5864,752,12188
"1114","2019-01-18",5211,5631,489,11331
"1115","2019-01-19",2867,4747,207,7821
"1116","2019-01-20",2454,4394,288,7136
"1117","2019-01-21",5420,5388,634,11442
"1118","2019-01-22",5414,5417,730,11561
"1119","2019-01-23",5061,5701,715,11477
"1120","2019-01-24",4830,5182,755,10767
"1121","2019-01-25",4809,5544,623,10976
"1122","2019-01-26",2541,5183,163,7887
"1123","2019-01-27",2364,4398,243,7005
"1124","2019-01-28",4821,4831,746,10398
"1125","2019-01-29",4857,5035,768,10660
"1126","2019-01-30",4662,4570,688,9920
"1127","2019-01-31",4617,3800,678,9095
"1128","2019-02-01",4265,4407,423,9095
"1129","2019-02-02",2271,4579,190,7040
"1130","2019-02-03",2001,4668,164,6833
"1131","2019-02-04",1975,5050,200,7225
"1132","2019-02-05",1725,5778,220,7723
"1133","2019-02-06",2120,4008,332,6460
"1134","2019-02-07",4436,4996,648,10080
"1135","2019-02-08",4483,5359,644,10486
"1136","2019-02-09",2529,4471,189,7189
"1137","2019-02-10",2188,4636,163,6987
"1138","2019-02-11",5071,4778,675,10524
"1139","2019-02-12",5358,5498,883,11739
"1140","2019-02-13",5261,5590,773,11624
"1141","2019-02-14",5151,4790,756,10697
"1142","2019-02-15",4974,4758,548,10280
"1143","2019-02-16",2701,4589,190,7480
"1144","2019-02-17",2742,4456,273,7471
"1145","2019-02-18",5254,5260,739,11253
"1146","2019-02-19",5247,4897,785,10929
"1147","2019-02-20",5346,6233,793,12372
"1148","2019-02-21",5016,5341,783,11140
"1149","2019-02-22",5063,4902,507,10472
"1150","2019-02-23",2644,4646,175,7465
"1151","2019-02-24",2610,4700,254,7564
"1152","2019-02-25",5804,5354,752,11910
"1153","2019-02-26",5089,4808,691,10588
"1154","2019-02-27",5190,4057,805,10052
"1155","2019-02-28",5009,5079,609,10697
"1156","2019-03-01",2958,4931,218,8107
"1157","2019-03-02",2781,4970,248,7999
"1158","2019-03-03",2671,4725,255,7651
"1159","2019-03-04",5062,5870,636,11568
"1160","2019-03-05",5865,5608,839,12312
"1161","2019-03-06",6189,5884,1061,13134
"1162","2019-03-07",5797,4988,890,11675
"1163","2019-03-08",5278,4247,613,10138
"1164","2019-03-09",2864,4019,214,7097
"1165","2019-03-10",2748,3962,358,7068
"1166","2019-03-11",5464,4433,888,10785
"1167","2019-03-12",5435,4110,751,10296
"1168","2019-03-13",5371,4173,737,10281
"1169","2019-03-14",5290,4076,880,10246
"1170","2019-03-15",5245,3908,652,9805
"1171","2019-03-16",2718,3603,225,6546
"1172","2019-03-17",2700,3586,261,6547
"1173","2019-03-18",5349,4525,848,10722
"1174","2019-03-19",5361,4348,803,10512
"1175","2019-03-20",5264,4555,756,10575
"1176","2019-03-21",5523,4332,807,10662
"1177","2019-03-22",5279,4201,604,10084
"1178","2019-03-23",2801,4166,197,7164
"1179","2019-03-24",2878,4509,257,7644
"1180","2019-03-25",5439,6500,716,12655
"1181","2019-03-26",5552,5045,877,11474
"1182","2019-03-27",5374,4655,884,10913
"1183","2019-03-28",5440,4459,787,10686
"1184","2019-03-29",5013,4160,521,9694
"1185","2019-03-30",2815,4050,201,7066
"1186","2019-03-31",2630,3958,370,6958
"1187","2019-04-01",5301,3986,720,10007
"1188","2019-04-02",5231,4364,700,10295
"1189","2019-04-03",5268,4028,815,10111
"1190","2019-04-04",5315,4707,715,10737
"1191","2019-04-05",5275,3895,641,9811
"1192","2019-04-06",2737,4221,250,7208
"1193","2019-04-07",2666,4282,314,7262
"1194","2019-04-08",5405,4483,770,10658
"1195","2019-04-09",5317,4863,733,10913
"1196","2019-04-10",5430,5786,894,12110
"1197","2019-04-11",5215,4754,761,10730
"1198","2019-04-12",4977,4269,640,9886
"1199","2019-04-13",2556,4056,206,6818
"1200","2019-04-14",2527,3452,306,6285
"1201","2019-04-15",5131,4847,707,10685
"1202","2019-04-16",4982,4277,619,9878
"1203","2019-04-17",5064,4384,784,10232
"1204","2019-04-18",4990,4444,891,10325
"1205","2019-04-19",4863,4702,654,10219
"1206","2019-04-20",2672,4443,209,7324
"1207","2019-04-21",2651,4051,319,7021
"1208","2019-04-22",5160,4493,889,10542
"1209","2019-04-23",5134,4500,757,10391
"1210","2019-04-24",5205,3910,855,9970
"1211","2019-04-25",5052,3666,785,9503
"1212","2019-04-26",4481,3856,723,9060
"1213","2019-04-27",2559,3158,154,5871
"1214","2019-04-28",2394,3888,200,6482
"1215","2019-04-29",5154,5662,800,11616
"1216","2019-04-30",4943,5030,777,10750
