"","social_hobby.date","social_hobby.blog","social_hobby.twitter","social_hobby.news","social_hobby.total"
"1","2016-01-01",621,1342,21,1984
"2","2016-01-02",640,1694,28,2362
"3","2016-01-03",628,1640,27,2295
"4","2016-01-04",922,1705,51,2678
"5","2016-01-05",965,1902,55,2922
"6","2016-01-06",955,1586,67,2608
"7","2016-01-07",899,1712,67,2678
"8","2016-01-08",836,1564,61,2461
"9","2016-01-09",640,1544,31,2215
"10","2016-01-10",644,1691,20,2355
"11","2016-01-11",898,1543,48,2489
"12","2016-01-12",866,1372,119,2357
"13","2016-01-13",940,1470,66,2476
"14","2016-01-14",989,1273,63,2325
"15","2016-01-15",784,1657,83,2524
"16","2016-01-16",611,1645,19,2275
"17","2016-01-17",640,1569,28,2237
"18","2016-01-18",906,1403,60,2369
"19","2016-01-19",923,1406,91,2420
"20","2016-01-20",932,1311,49,2292
"21","2016-01-21",921,1550,50,2521
"22","2016-01-22",850,1748,57,2655
"23","2016-01-23",730,1906,22,2658
"24","2016-01-24",669,1817,16,2502
"25","2016-01-25",912,2152,38,3102
"26","2016-01-26",926,1826,40,2792
"27","2016-01-27",890,1992,45,2927
"28","2016-01-28",846,2121,72,3039
"29","2016-01-29",859,2109,58,3026
"30","2016-01-30",654,2005,26,2685
"31","2016-01-31",569,1966,33,2568
"32","2016-02-01",863,2109,40,3012
"33","2016-02-02",870,1911,54,2835
"34","2016-02-03",849,1818,48,2715
"35","2016-02-04",782,1575,56,2413
"36","2016-02-05",771,1859,71,2701
"37","2016-02-06",552,1756,30,2338
"38","2016-02-07",445,2047,17,2509
"39","2016-02-08",467,1950,13,2430
"40","2016-02-09",513,1949,12,2474
"41","2016-02-10",695,2151,18,2864
"42","2016-02-11",862,2343,44,3249
"43","2016-02-12",866,2016,52,2934
"44","2016-02-13",700,2086,22,2808
"45","2016-02-14",677,2143,19,2839
"46","2016-02-15",896,2254,65,3215
"47","2016-02-16",930,2075,63,3068
"48","2016-02-17",862,1882,50,2794
"49","2016-02-18",938,1853,53,2844
"50","2016-02-19",885,1970,43,2898
"51","2016-02-20",645,1967,11,2623
"52","2016-02-21",686,2103,20,2809
"53","2016-02-22",980,2201,58,3239
"54","2016-02-23",962,2234,34,3230
"55","2016-02-24",962,1713,65,2740
"56","2016-02-25",875,1622,51,2548
"57","2016-02-26",815,2724,72,3611
"58","2016-02-27",742,2034,16,2792
"59","2016-02-28",676,2114,38,2828
"60","2016-02-29",847,2005,57,2909
"61","2016-03-01",681,2025,24,2730
"62","2016-03-02",815,1922,64,2801
"63","2016-03-03",834,1460,63,2357
"64","2016-03-04",753,1719,63,2535
"65","2016-03-05",612,2005,25,2642
"66","2016-03-06",596,2116,14,2726
"67","2016-03-07",834,1717,41,2592
"68","2016-03-08",840,1714,38,2592
"69","2016-03-09",824,1583,46,2453
"70","2016-03-10",798,1554,29,2381
"71","2016-03-11",683,1647,44,2374
"72","2016-03-12",509,1593,15,2117
"73","2016-03-13",592,2162,12,2766
"74","2016-03-14",825,1706,69,2600
"75","2016-03-15",770,1632,60,2462
"76","2016-03-16",759,1709,62,2530
"77","2016-03-17",741,1583,42,2366
"78","2016-03-18",752,1751,51,2554
"79","2016-03-19",550,1869,23,2442
"80","2016-03-20",639,2013,9,2661
"81","2016-03-21",840,1705,46,2591
"82","2016-03-22",903,1799,33,2735
"83","2016-03-23",837,1184,40,2061
"84","2016-03-24",962,1578,43,2583
"85","2016-03-25",937,1527,32,2496
"86","2016-03-26",792,1711,19,2522
"87","2016-03-27",786,2265,19,3070
"88","2016-03-28",1095,2040,55,3190
"89","2016-03-29",1048,1822,48,2918
"90","2016-03-30",1028,1759,63,2850
"91","2016-03-31",1023,1415,71,2509
"92","2016-04-01",899,1487,79,2465
"93","2016-04-02",754,1795,42,2591
"94","2016-04-03",845,2153,40,3038
"95","2016-04-04",1001,2072,54,3127
"96","2016-04-05",1059,1755,105,2919
"97","2016-04-06",982,1773,42,2797
"98","2016-04-07",983,1764,63,2810
"99","2016-04-08",937,1593,47,2577
"100","2016-04-09",743,1884,22,2649
"101","2016-04-10",762,2278,28,3068
"102","2016-04-11",1021,1824,27,2872
"103","2016-04-12",958,1637,54,2649
"104","2016-04-13",851,1657,32,2540
"105","2016-04-14",913,1718,28,2659
"106","2016-04-15",854,1550,44,2448
"107","2016-04-16",719,1730,6,2455
"108","2016-04-17",748,2132,16,2896
"109","2016-04-18",1002,2000,37,3039
"110","2016-04-19",965,1781,30,2776
"111","2016-04-20",987,1696,50,2733
"112","2016-04-21",1001,1763,44,2808
"113","2016-04-22",916,1734,28,2678
"114","2016-04-23",710,1785,11,2506
"115","2016-04-24",775,2167,9,2951
"116","2016-04-25",998,1883,48,2929
"117","2016-04-26",1044,2078,50,3172
"118","2016-04-27",1013,2314,42,3369
"119","2016-04-28",913,1721,67,2701
"120","2016-04-29",883,1609,34,2526
"121","2016-04-30",690,1552,19,2261
"122","2016-05-01",759,2037,23,2819
"123","2016-05-02",966,1885,47,2898
"124","2016-05-03",998,2035,57,3090
"125","2016-05-04",820,3012,43,3875
"126","2016-05-05",663,2047,42,2752
"127","2016-05-06",769,1994,29,2792
"128","2016-05-07",653,1853,19,2525
"129","2016-05-08",704,2231,53,2988
"130","2016-05-09",978,2048,47,3073
"131","2016-05-10",952,1815,55,2822
"132","2016-05-11",900,1742,46,2688
"133","2016-05-12",841,1628,50,2519
"134","2016-05-13",926,1545,25,2496
"135","2016-05-14",617,1627,24,2268
"136","2016-05-15",806,2296,43,3145
"137","2016-05-16",933,2045,47,3025
"138","2016-05-17",880,4450,47,5377
"139","2016-05-18",904,2216,75,3195
"140","2016-05-19",902,1694,42,2638
"141","2016-05-20",819,1571,49,2439
"142","2016-05-21",619,1728,23,2370
"143","2016-05-22",677,2550,26,3253
"144","2016-05-23",922,2026,74,3022
"145","2016-05-24",940,1780,50,2770
"146","2016-05-25",886,1705,33,2624
"147","2016-05-26",811,1651,48,2510
"148","2016-05-27",774,1552,37,2363
"149","2016-05-28",659,1747,5,2411
"150","2016-05-29",672,2224,14,2910
"151","2016-05-30",895,1945,58,2898
"152","2016-05-31",922,1887,35,2844
"153","2016-06-01",853,2332,68,3253
"154","2016-06-02",935,1701,60,2696
"155","2016-06-03",843,1749,34,2626
"156","2016-06-04",695,1704,20,2419
"157","2016-06-05",614,1970,13,2597
"158","2016-06-06",804,2012,20,2836
"159","2016-06-07",970,2251,34,3255
"160","2016-06-08",996,1977,24,2997
"161","2016-06-09",999,1940,38,2977
"162","2016-06-10",918,1082,38,2038
"163","2016-06-11",702,1680,12,2394
"164","2016-06-12",739,2208,14,2961
"165","2016-06-13",948,2128,54,3130
"166","2016-06-14",988,1943,45,2976
"167","2016-06-15",924,1951,52,2927
"168","2016-06-16",1032,1895,42,2969
"169","2016-06-17",965,1930,46,2941
"170","2016-06-18",688,2013,10,2711
"171","2016-06-19",692,2214,24,2930
"172","2016-06-20",936,2251,48,3235
"173","2016-06-21",910,1763,49,2722
"174","2016-06-22",962,1832,86,2880
"175","2016-06-23",891,2005,48,2944
"176","2016-06-24",952,1739,39,2730
"177","2016-06-25",670,1837,40,2547
"178","2016-06-26",731,2151,10,2892
"179","2016-06-27",951,2082,57,3090
"180","2016-06-28",981,1879,74,2934
"181","2016-06-29",946,1782,33,2761
"182","2016-06-30",943,1863,41,2847
"183","2016-07-01",881,1682,35,2598
"184","2016-07-02",727,1954,28,2709
"185","2016-07-03",681,2133,20,2834
"186","2016-07-04",981,2465,51,3497
"187","2016-07-05",903,1951,64,2918
"188","2016-07-06",839,1791,64,2694
"189","2016-07-07",931,1773,45,2749
"190","2016-07-08",828,1720,21,2569
"191","2016-07-09",692,1805,15,2512
"192","2016-07-10",675,2366,13,3054
"193","2016-07-11",928,2187,69,3184
"194","2016-07-12",946,1941,42,2929
"195","2016-07-13",907,1783,63,2753
"196","2016-07-14",834,1698,54,2586
"197","2016-07-15",880,1799,50,2729
"198","2016-07-16",708,1836,21,2565
"199","2016-07-17",687,2314,18,3019
"200","2016-07-18",968,2425,23,3416
"201","2016-07-19",866,2555,39,3460
"202","2016-07-20",924,2261,35,3220
"203","2016-07-21",943,2152,44,3139
"204","2016-07-22",870,2053,37,2960
"205","2016-07-23",723,2155,18,2896
"206","2016-07-24",696,2194,20,2910
"207","2016-07-25",947,2255,59,3261
"208","2016-07-26",957,2535,34,3526
"209","2016-07-27",3485,2288,45,5818
"210","2016-07-28",890,2118,47,3055
"211","2016-07-29",827,2041,31,2899
"212","2016-07-30",658,1894,8,2560
"213","2016-07-31",639,1808,14,2461
"214","2016-08-01",883,2105,48,3036
"215","2016-08-02",899,2233,31,3163
"216","2016-08-03",938,2264,30,3232
"217","2016-08-04",885,2279,27,3191
"218","2016-08-05",858,2042,24,2924
"219","2016-08-06",705,2058,9,2772
"220","2016-08-07",655,2235,17,2907
"221","2016-08-08",884,2193,47,3124
"222","2016-08-09",916,2150,28,3094
"223","2016-08-10",857,2072,36,2965
"224","2016-08-11",855,2296,38,3189
"225","2016-08-12",790,2243,45,3078
"226","2016-08-13",637,2793,15,3445
"227","2016-08-14",597,2921,14,3532
"228","2016-08-15",659,2619,20,3298
"229","2016-08-16",840,2189,46,3075
"230","2016-08-17",886,2179,42,3107
"231","2016-08-18",898,1916,44,2858
"232","2016-08-19",809,1987,41,2837
"233","2016-08-20",683,2080,18,2781
"234","2016-08-21",658,2280,20,2958
"235","2016-08-22",928,2048,40,3016
"236","2016-08-23",932,2443,45,3420
"237","2016-08-24",932,2188,83,3203
"238","2016-08-25",816,2044,46,2906
"239","2016-08-26",808,1762,36,2606
"240","2016-08-27",654,1811,19,2484
"241","2016-08-28",662,2097,18,2777
"242","2016-08-29",895,1797,48,2740
"243","2016-08-30",890,1802,16,2708
"244","2016-08-31",872,1911,51,2834
"245","2016-09-01",839,1979,33,2851
"246","2016-09-02",839,1867,40,2746
"247","2016-09-03",594,2018,5,2617
"248","2016-09-04",637,2306,18,2961
"249","2016-09-05",839,2008,25,2872
"250","2016-09-06",841,1792,48,2681
"251","2016-09-07",899,1759,42,2700
"252","2016-09-08",822,1763,43,2628
"253","2016-09-09",826,1998,36,2860
"254","2016-09-10",631,1981,10,2622
"255","2016-09-11",619,2373,23,3015
"256","2016-09-12",766,1752,52,2570
"257","2016-09-13",676,2544,47,3267
"258","2016-09-14",481,2559,24,3064
"259","2016-09-15",443,2882,21,3346
"260","2016-09-16",485,2616,16,3117
"261","2016-09-17",626,2584,35,3245
"262","2016-09-18",691,2467,17,3175
"263","2016-09-19",871,1868,29,2768
"264","2016-09-20",851,1799,43,2693
"265","2016-09-21",840,1779,36,2655
"266","2016-09-22",780,1924,67,2771
"267","2016-09-23",799,1866,49,2714
"268","2016-09-24",643,1854,30,2527
"269","2016-09-25",715,2241,14,2970
"270","2016-09-26",908,1926,37,2871
"271","2016-09-27",875,1793,41,2709
"272","2016-09-28",976,1848,37,2861
"273","2016-09-29",801,1854,40,2695
"274","2016-09-30",837,1709,53,2599
"275","2016-10-01",627,1880,21,2528
"276","2016-10-02",632,2162,19,2813
"277","2016-10-03",751,2417,23,3191
"278","2016-10-04",895,2063,38,2996
"279","2016-10-05",863,1896,66,2825
"280","2016-10-06",804,1860,43,2707
"281","2016-10-07",816,1795,56,2667
"282","2016-10-08",647,1959,35,2641
"283","2016-10-09",672,2069,24,2765
"284","2016-10-10",890,1874,30,2794
"285","2016-10-11",806,1766,58,2630
"286","2016-10-12",945,1766,82,2793
"287","2016-10-13",869,1752,95,2716
"288","2016-10-14",861,1907,56,2824
"289","2016-10-15",592,1788,24,2404
"290","2016-10-16",700,2103,16,2819
"291","2016-10-17",956,2111,62,3129
"292","2016-10-18",885,1910,42,2837
"293","2016-10-19",888,2010,63,2961
"294","2016-10-20",861,1964,63,2888
"295","2016-10-21",796,1869,56,2721
"296","2016-10-22",633,1835,42,2510
"297","2016-10-23",688,2288,50,3026
"298","2016-10-24",902,1996,39,2937
"299","2016-10-25",896,1706,57,2659
"300","2016-10-26",872,2243,56,3171
"301","2016-10-27",778,1892,60,2730
"302","2016-10-28",921,1755,57,2733
"303","2016-10-29",617,1907,33,2557
"304","2016-10-30",588,2213,17,2818
"305","2016-10-31",843,1908,87,2838
"306","2016-11-01",834,1832,56,2722
"307","2016-11-02",799,2247,49,3095
"308","2016-11-03",926,1888,63,2877
"309","2016-11-04",786,1722,39,2547
"310","2016-11-05",600,2012,24,2636
"311","2016-11-06",685,2384,20,3089
"312","2016-11-07",822,2119,61,3002
"313","2016-11-08",908,1892,124,2924
"314","2016-11-09",806,1333,102,2241
"315","2016-11-10",766,1842,49,2657
"316","2016-11-11",731,1992,23,2746
"317","2016-11-12",574,1857,24,2455
"318","2016-11-13",610,1990,7,2607
"319","2016-11-14",868,2236,39,3143
"320","2016-11-15",859,2108,43,3010
"321","2016-11-16",846,2252,29,3127
"322","2016-11-17",795,1700,45,2540
"323","2016-11-18",838,1884,59,2781
"324","2016-11-19",637,1656,30,2323
"325","2016-11-20",644,1909,10,2563
"326","2016-11-21",838,2513,41,3392
"327","2016-11-22",861,2603,48,3512
"328","2016-11-23",896,2062,34,2992
"329","2016-11-24",829,1810,49,2688
"330","2016-11-25",802,1955,38,2795
"331","2016-11-26",593,1920,20,2533
"332","2016-11-27",602,2204,6,2812
"333","2016-11-28",836,2112,37,2985
"334","2016-11-29",839,1938,64,2841
"335","2016-11-30",842,1899,56,2797
"336","2016-12-01",906,1982,37,2925
"337","2016-12-02",808,1678,41,2527
"338","2016-12-03",661,1680,23,2364
"339","2016-12-04",623,2028,16,2667
"340","2016-12-05",837,2186,48,3071
"341","2016-12-06",935,1886,56,2877
"342","2016-12-07",848,1822,40,2710
"343","2016-12-08",799,1939,47,2785
"344","2016-12-09",752,1688,30,2470
"345","2016-12-10",646,2134,12,2792
"346","2016-12-11",657,2327,17,3001
"347","2016-12-12",817,2584,47,3448
"348","2016-12-13",835,2091,52,2978
"349","2016-12-14",792,1981,51,2824
"350","2016-12-15",816,1829,57,2702
"351","2016-12-16",757,1846,44,2647
"352","2016-12-17",635,1901,27,2563
"353","2016-12-18",583,2358,22,2963
"354","2016-12-19",883,2087,37,3007
"355","2016-12-20",843,2138,30,3011
"356","2016-12-21",843,1908,45,2796
"357","2016-12-22",812,1919,37,2768
"358","2016-12-23",771,2266,47,3084
"359","2016-12-24",574,1954,17,2545
"360","2016-12-25",548,2208,19,2775
"361","2016-12-26",815,2239,19,3073
"362","2016-12-27",861,2092,42,2995
"363","2016-12-28",918,2277,29,3224
"364","2016-12-29",947,2009,82,3038
"365","2016-12-30",779,1810,43,2632
"366","2016-12-31",700,2112,29,2841
"367","2017-01-01",663,2123,19,2805
"368","2017-01-02",851,2505,7,3363
"369","2017-01-03",976,2518,30,3524
"370","2017-01-04",894,2450,53,3397
"371","2017-01-05",923,2411,88,3422
"372","2017-01-06",923,2238,30,3191
"373","2017-01-07",703,2193,18,2914
"374","2017-01-08",738,2359,9,3106
"375","2017-01-09",949,2388,38,3375
"376","2017-01-10",953,2335,54,3342
"377","2017-01-11",963,2286,47,3296
"378","2017-01-12",927,2371,73,3371
"379","2017-01-13",886,2265,46,3197
"380","2017-01-14",699,2008,39,2746
"381","2017-01-15",697,2322,28,3047
"382","2017-01-16",944,2347,66,3357
"383","2017-01-17",943,2416,46,3405
"384","2017-01-18",1004,2448,120,3572
"385","2017-01-19",977,2450,40,3467
"386","2017-01-20",864,2226,31,3121
"387","2017-01-21",651,1968,32,2651
"388","2017-01-22",734,2328,11,3073
"389","2017-01-23",957,2729,52,3738
"390","2017-01-24",924,2420,50,3394
"391","2017-01-25",860,2202,72,3134
"392","2017-01-26",689,2198,35,2922
"393","2017-01-27",500,2311,22,2833
"394","2017-01-28",383,2164,16,2563
"395","2017-01-29",476,2287,15,2778
"396","2017-01-30",731,2603,16,3350
"397","2017-01-31",964,2596,27,3587
"398","2017-02-01",938,2479,36,3453
"399","2017-02-02",891,2514,71,3476
"400","2017-02-03",855,2219,31,3105
"401","2017-02-04",738,2510,11,3259
"402","2017-02-05",749,2212,33,2994
"403","2017-02-06",943,2325,40,3308
"404","2017-02-07",932,2087,35,3054
"405","2017-02-08",984,1752,47,2783
"406","2017-02-09",901,1810,72,2783
"407","2017-02-10",895,2088,59,3042
"408","2017-02-11",750,2149,19,2918
"409","2017-02-12",732,2422,39,3193
"410","2017-02-13",973,2348,62,3383
"411","2017-02-14",905,2324,54,3283
"412","2017-02-15",1003,2462,73,3538
"413","2017-02-16",961,2234,67,3262
"414","2017-02-17",922,2415,60,3397
"415","2017-02-18",719,2324,32,3075
"416","2017-02-19",798,2548,38,3384
"417","2017-02-20",1087,2521,59,3667
"418","2017-02-21",1012,2499,87,3598
"419","2017-02-22",988,2278,42,3308
"420","2017-02-23",987,2162,44,3193
"421","2017-02-24",945,2219,94,3258
"422","2017-02-25",707,2318,23,3048
"423","2017-02-26",754,2326,21,3101
"424","2017-02-27",972,2233,32,3237
"425","2017-02-28",925,2565,56,3546
"426","2017-03-01",838,2603,18,3459
"427","2017-03-02",834,2381,48,3263
"428","2017-03-03",821,2048,37,2906
"429","2017-03-04",645,2265,18,2928
"430","2017-03-05",724,2422,18,3164
"431","2017-03-06",942,2189,54,3185
"432","2017-03-07",903,2068,83,3054
"433","2017-03-08",978,1998,76,3052
"434","2017-03-09",955,1674,65,2694
"435","2017-03-10",802,1116,25,1943
"436","2017-03-11",605,1928,21,2554
"437","2017-03-12",712,2087,12,2811
"438","2017-03-13",925,1972,36,2933
"439","2017-03-14",837,1837,84,2758
"440","2017-03-15",878,1876,84,2838
"441","2017-03-16",863,1806,24,2693
"442","2017-03-17",892,1761,53,2706
"443","2017-03-18",653,1924,28,2605
"444","2017-03-19",664,2323,37,3024
"445","2017-03-20",960,2062,50,3072
"446","2017-03-21",969,1932,43,2944
"447","2017-03-22",942,1887,95,2924
"448","2017-03-23",881,1777,81,2739
"449","2017-03-24",836,1805,43,2684
"450","2017-03-25",695,2061,42,2798
"451","2017-03-26",659,2113,15,2787
"452","2017-03-27",939,2275,29,3243
"453","2017-03-28",924,1868,63,2855
"454","2017-03-29",1006,1806,60,2872
"455","2017-03-30",933,1740,81,2754
"456","2017-03-31",838,1867,77,2782
"457","2017-04-01",677,2044,23,2744
"458","2017-04-02",648,2151,14,2813
"459","2017-04-03",845,2072,44,2961
"460","2017-04-04",884,1898,57,2839
"461","2017-04-05",930,1868,49,2847
"462","2017-04-06",911,1815,56,2782
"463","2017-04-07",810,1872,41,2723
"464","2017-04-08",630,1839,13,2482
"465","2017-04-09",665,2045,18,2728
"466","2017-04-10",881,1960,42,2883
"467","2017-04-11",907,1689,39,2635
"468","2017-04-12",954,1770,47,2771
"469","2017-04-13",880,1832,47,2759
"470","2017-04-14",849,1906,36,2791
"471","2017-04-15",647,2053,37,2737
"472","2017-04-16",642,2967,24,3633
"473","2017-04-17",923,2088,53,3064
"474","2017-04-18",913,2038,56,3007
"475","2017-04-19",879,1793,36,2708
"476","2017-04-20",871,1730,44,2645
"477","2017-04-21",847,1804,68,2719
"478","2017-04-22",663,1682,23,2368
"479","2017-04-23",724,2308,44,3076
"480","2017-04-24",916,3558,50,4524
"481","2017-04-25",923,2069,169,3161
"482","2017-04-26",912,1725,50,2687
"483","2017-04-27",920,1981,45,2946
"484","2017-04-28",841,1894,53,2788
"485","2017-04-29",633,2049,17,2699
"486","2017-04-30",679,2335,61,3075
"487","2017-05-01",844,2188,59,3091
"488","2017-05-02",846,2284,38,3168
"489","2017-05-03",688,2165,12,2865
"490","2017-05-04",814,2588,29,3431
"491","2017-05-05",643,2183,32,2858
"492","2017-05-06",606,2045,13,2664
"493","2017-05-07",642,2154,23,2819
"494","2017-05-08",802,2270,39,3111
"495","2017-05-09",795,1826,21,2642
"496","2017-05-10",815,1912,55,2782
"497","2017-05-11",818,1790,35,2643
"498","2017-05-12",773,2023,43,2839
"499","2017-05-13",637,1964,29,2630
"500","2017-05-14",720,2282,25,3027
"501","2017-05-15",877,2317,44,3238
"502","2017-05-16",871,2574,37,3482
"503","2017-05-17",792,2222,44,3058
"504","2017-05-18",786,2095,82,2963
"505","2017-05-19",752,1956,41,2749
"506","2017-05-20",569,1873,26,2468
"507","2017-05-21",647,2082,18,2747
"508","2017-05-22",938,2055,58,3051
"509","2017-05-23",861,2059,53,2973
"510","2017-05-24",871,2029,54,2954
"511","2017-05-25",869,1861,33,2763
"512","2017-05-26",795,1774,57,2626
"513","2017-05-27",640,1581,29,2250
"514","2017-05-28",636,1920,29,2585
"515","2017-05-29",941,1947,88,2976
"516","2017-05-30",918,2056,70,3044
"517","2017-05-31",850,1900,45,2795
"518","2017-06-01",851,1866,56,2773
"519","2017-06-02",745,2040,38,2823
"520","2017-06-03",565,2213,20,2798
"521","2017-06-04",707,2292,16,3015
"522","2017-06-05",890,2320,91,3301
"523","2017-06-06",792,2110,25,2927
"524","2017-06-07",937,2151,35,3123
"525","2017-06-08",879,2344,49,3272
"526","2017-06-09",792,3063,57,3912
"527","2017-06-10",554,1890,11,2455
"528","2017-06-11",659,2448,19,3126
"529","2017-06-12",854,2373,48,3275
"530","2017-06-13",927,2384,26,3337
"531","2017-06-14",883,1910,89,2882
"532","2017-06-15",858,1754,43,2655
"533","2017-06-16",821,1855,37,2713
"534","2017-06-17",601,1467,21,2089
"535","2017-06-18",634,3142,18,3794
"536","2017-06-19",882,1969,41,2892
"537","2017-06-20",888,1938,28,2854
"538","2017-06-21",889,1819,46,2754
"539","2017-06-22",901,1858,53,2812
"540","2017-06-23",774,1862,39,2675
"541","2017-06-24",592,1766,21,2379
"542","2017-06-25",611,2192,20,2823
"543","2017-06-26",867,2095,53,3015
"544","2017-06-27",856,1794,59,2709
"545","2017-06-28",865,1952,38,2855
"546","2017-06-29",856,1969,51,2876
"547","2017-06-30",833,1844,42,2719
"548","2017-07-01",637,1649,35,2321
"549","2017-07-02",642,1691,17,2350
"550","2017-07-03",860,1788,47,2695
"551","2017-07-04",865,1827,33,2725
"552","2017-07-05",870,2399,48,3317
"553","2017-07-06",777,2459,59,3295
"554","2017-07-07",885,2196,46,3127
"555","2017-07-08",632,1845,41,2518
"556","2017-07-09",680,2079,40,2799
"557","2017-07-10",834,1893,38,2765
"558","2017-07-11",859,1916,33,2808
"559","2017-07-12",809,1768,48,2625
"560","2017-07-13",2240,1754,54,4048
"561","2017-07-14",826,1868,46,2740
"562","2017-07-15",638,1848,18,2504
"563","2017-07-16",645,2202,27,2874
"564","2017-07-17",917,2177,29,3123
"565","2017-07-18",928,1820,54,2802
"566","2017-07-19",913,1966,59,2938
"567","2017-07-20",863,1917,54,2834
"568","2017-07-21",863,2019,52,2934
"569","2017-07-22",560,1956,29,2545
"570","2017-07-23",735,2168,23,2926
"571","2017-07-24",903,2313,62,3278
"572","2017-07-25",941,2062,37,3040
"573","2017-07-26",853,2054,46,2953
"574","2017-07-27",820,1938,80,2838
"575","2017-07-28",850,1981,63,2894
"576","2017-07-29",643,2179,28,2850
"577","2017-07-30",664,2051,27,2742
"578","2017-07-31",868,2215,55,3138
"579","2017-08-01",839,2358,86,3283
"580","2017-08-02",891,2065,60,3016
"581","2017-08-03",845,2090,82,3017
"582","2017-08-04",784,2023,48,2855
"583","2017-08-05",625,1904,16,2545
"584","2017-08-06",602,2044,36,2682
"585","2017-08-07",948,1969,32,2949
"586","2017-08-08",912,2075,46,3033
"587","2017-08-09",931,2103,82,3116
"588","2017-08-10",868,1784,66,2718
"589","2017-08-11",845,1841,46,2732
"590","2017-08-12",647,1897,18,2562
"591","2017-08-13",634,1880,15,2529
"592","2017-08-14",829,2082,40,2951
"593","2017-08-15",705,2176,22,2903
"594","2017-08-16",899,1947,42,2888
"595","2017-08-17",1032,1751,43,2826
"596","2017-08-18",837,1906,37,2780
"597","2017-08-19",641,2006,15,2662
"598","2017-08-20",725,2125,9,2859
"599","2017-08-21",970,2091,51,3112
"600","2017-08-22",958,1915,42,2915
"601","2017-08-23",946,2092,52,3090
"602","2017-08-24",957,1937,53,2947
"603","2017-08-25",829,1884,27,2740
"604","2017-08-26",613,2006,37,2656
"605","2017-08-27",690,2067,22,2779
"606","2017-08-28",936,1847,55,2838
"607","2017-08-29",864,1796,63,2723
"608","2017-08-30",910,1689,53,2652
"609","2017-08-31",928,1371,84,2383
"610","2017-09-01",772,1668,70,2510
"611","2017-09-02",664,1927,9,2600
"612","2017-09-03",789,2141,35,2965
"613","2017-09-04",939,2037,56,3032
"614","2017-09-05",915,1681,52,2648
"615","2017-09-06",883,1621,42,2546
"616","2017-09-07",854,1621,67,2542
"617","2017-09-08",860,1451,33,2344
"618","2017-09-09",568,1754,35,2357
"619","2017-09-10",676,1988,43,2707
"620","2017-09-11",951,1975,67,2993
"621","2017-09-12",835,1587,48,2470
"622","2017-09-13",908,1687,33,2628
"623","2017-09-14",809,1533,75,2417
"624","2017-09-15",843,1600,36,2479
"625","2017-09-16",627,1578,14,2219
"626","2017-09-17",674,1829,22,2525
"627","2017-09-18",921,1967,61,2949
"628","2017-09-19",871,1730,47,2648
"629","2017-09-20",885,1641,44,2570
"630","2017-09-21",858,1501,34,2393
"631","2017-09-22",767,1562,42,2371
"632","2017-09-23",595,1633,18,2246
"633","2017-09-24",624,1833,13,2470
"634","2017-09-25",901,1758,76,2735
"635","2017-09-26",852,1645,40,2537
"636","2017-09-27",805,1717,36,2558
"637","2017-09-28",746,1544,56,2346
"638","2017-09-29",721,1592,58,2371
"639","2017-09-30",591,1577,15,2183
"640","2017-10-01",542,1780,29,2351
"641","2017-10-02",586,2039,25,2650
"642","2017-10-03",422,2029,26,2477
"643","2017-10-04",332,2054,17,2403
"644","2017-10-05",475,2057,15,2547
"645","2017-10-06",547,3585,39,4171
"646","2017-10-07",568,3570,16,4154
"647","2017-10-08",601,2360,29,2990
"648","2017-10-09",737,2413,21,3171
"649","2017-10-10",810,2146,48,3004
"650","2017-10-11",852,1738,77,2667
"651","2017-10-12",751,1821,44,2616
"652","2017-10-13",805,1657,36,2498
"653","2017-10-14",599,1629,34,2262
"654","2017-10-15",589,1836,36,2461
"655","2017-10-16",849,1823,61,2733
"656","2017-10-17",858,2331,57,3246
"657","2017-10-18",871,2291,47,3209
"658","2017-10-19",774,1929,71,2774
"659","2017-10-20",754,2042,53,2849
"660","2017-10-21",586,2012,24,2622
"661","2017-10-22",692,2104,27,2823
"662","2017-10-23",905,1981,72,2958
"663","2017-10-24",832,1815,48,2695
"664","2017-10-25",863,1648,146,2657
"665","2017-10-26",848,1380,52,2280
"666","2017-10-27",843,1833,48,2724
"667","2017-10-28",582,1704,21,2307
"668","2017-10-29",682,2015,29,2726
"669","2017-10-30",865,1698,55,2618
"670","2017-10-31",819,1506,50,2375
"671","2017-11-01",839,2214,67,3120
"672","2017-11-02",859,1757,49,2665
"673","2017-11-03",935,1724,38,2697
"674","2017-11-04",637,1841,15,2493
"675","2017-11-05",681,2031,33,2745
"676","2017-11-06",828,2001,42,2871
"677","2017-11-07",845,1876,66,2787
"678","2017-11-08",870,1860,46,2776
"679","2017-11-09",766,1738,42,2546
"680","2017-11-10",1721,1699,46,3466
"681","2017-11-11",626,1788,24,2438
"682","2017-11-12",657,1987,27,2671
"683","2017-11-13",986,1799,62,2847
"684","2017-11-14",893,1861,35,2789
"685","2017-11-15",815,1607,40,2462
"686","2017-11-16",888,1675,43,2606
"687","2017-11-17",819,1582,46,2447
"688","2017-11-18",666,1633,25,2324
"689","2017-11-19",698,1838,18,2554
"690","2017-11-20",857,1720,34,2611
"691","2017-11-21",839,1443,36,2318
"692","2017-11-22",821,1565,41,2427
"693","2017-11-23",861,1444,38,2343
"694","2017-11-24",768,1552,62,2382
"695","2017-11-25",616,1416,17,2049
"696","2017-11-26",644,1686,26,2356
"697","2017-11-27",893,1559,73,2525
"698","2017-11-28",815,1540,46,2401
"699","2017-11-29",843,1590,33,2466
"700","2017-11-30",848,1203,60,2111
"701","2017-12-01",816,1282,34,2132
"702","2017-12-02",618,1086,13,1717
"703","2017-12-03",632,1632,39,2303
"704","2017-12-04",892,1757,75,2724
"705","2017-12-05",813,1727,42,2582
"706","2017-12-06",870,1424,32,2326
"707","2017-12-07",845,1593,46,2484
"708","2017-12-08",823,1424,76,2323
"709","2017-12-09",596,1558,12,2166
"710","2017-12-10",591,1572,24,2187
"711","2017-12-11",822,1622,61,2505
"712","2017-12-12",789,1417,45,2251
"713","2017-12-13",856,1545,48,2449
"714","2017-12-14",761,1449,37,2247
"715","2017-12-15",768,1297,56,2121
"716","2017-12-16",596,1520,25,2141
"717","2017-12-17",577,1773,17,2367
"718","2017-12-18",771,1458,36,2265
"719","2017-12-19",913,1181,50,2144
"720","2017-12-20",990,1783,38,2811
"721","2017-12-21",954,1218,42,2214
"722","2017-12-22",948,1502,34,2484
"723","2017-12-23",719,1758,21,2498
"724","2017-12-24",709,1587,11,2307
"725","2017-12-25",722,1570,11,2303
"726","2017-12-26",1033,1674,65,2772
"727","2017-12-27",1011,1772,35,2818
"728","2017-12-28",929,1624,66,2619
"729","2017-12-29",944,1641,35,2620
"730","2017-12-30",808,1470,25,2303
"731","2017-12-31",843,1538,10,2391
"732","2018-01-01",901,1510,29,2440
"733","2018-01-02",1075,1832,60,2967
"734","2018-01-03",1063,1849,28,2940
"735","2018-01-04",1047,1833,52,2932
"736","2018-01-05",1029,1826,39,2894
"737","2018-01-06",822,1840,19,2681
"738","2018-01-07",877,1938,21,2836
"739","2018-01-08",1106,2011,63,3180
"740","2018-01-09",1150,1912,39,3101
"741","2018-01-10",1069,1742,43,2854
"742","2018-01-11",1084,1482,87,2653
"743","2018-01-12",1006,1520,43,2569
"744","2018-01-13",839,1501,31,2371
"745","2018-01-14",835,1727,26,2588
"746","2018-01-15",1162,1584,36,2782
"747","2018-01-16",995,1860,62,2917
"748","2018-01-17",1170,1869,40,3079
"749","2018-01-18",1102,1777,40,2919
"750","2018-01-19",1091,1878,33,3002
"751","2018-01-20",852,1132,21,2005
"752","2018-01-21",908,1853,27,2788
"753","2018-01-22",1205,1879,48,3132
"754","2018-01-23",1045,1790,60,2895
"755","2018-01-24",988,1787,48,2823
"756","2018-01-25",986,1567,57,2610
"757","2018-01-26",903,1420,36,2359
"758","2018-01-27",755,1034,23,1812
"759","2018-01-28",735,1936,20,2691
"760","2018-01-29",2012,2523,44,4579
"761","2018-01-30",1059,2093,59,3211
"762","2018-01-31",988,1727,37,2752
"763","2018-02-01",989,1731,51,2771
"764","2018-02-02",950,1568,65,2583
"765","2018-02-03",781,1634,16,2431
"766","2018-02-04",767,1462,10,2239
"767","2018-02-05",1039,1607,51,2697
"768","2018-02-06",974,1634,55,2663
"769","2018-02-07",916,1484,47,2447
"770","2018-02-08",981,1452,42,2475
"771","2018-02-09",822,1525,39,2386
"772","2018-02-10",691,976,17,1684
"773","2018-02-11",667,1689,18,2374
"774","2018-02-12",974,1856,62,2892
"775","2018-02-13",914,1564,50,2528
"776","2018-02-14",856,1456,59,2371
"777","2018-02-15",575,1543,20,2138
"778","2018-02-16",449,1523,19,1991
"779","2018-02-17",461,1577,26,2064
"780","2018-02-18",686,1663,48,2397
"781","2018-02-19",544,1705,63,2312
"782","2018-02-20",651,1762,43,2456
"783","2018-02-21",964,1511,75,2550
"784","2018-02-22",905,1739,42,2686
"785","2018-02-23",860,1548,41,2449
"786","2018-02-24",645,1330,29,2004
"787","2018-02-25",686,1281,40,2007
"788","2018-02-26",969,1509,53,2531
"789","2018-02-27",952,1535,40,2527
"790","2018-02-28",956,1604,62,2622
"791","2018-03-01",796,1650,25,2471
"792","2018-03-02",864,1401,53,2318
"793","2018-03-03",692,1625,22,2339
"794","2018-03-04",776,1765,39,2580
"795","2018-03-05",908,1716,50,2674
"796","2018-03-06",891,1719,25,2635
"797","2018-03-07",910,1648,82,2640
"798","2018-03-08",959,1595,43,2597
"799","2018-03-09",899,1241,56,2196
"800","2018-03-10",760,1643,32,2435
"801","2018-03-11",769,1787,17,2573
"802","2018-03-12",967,1539,68,2574
"803","2018-03-13",953,1612,63,2628
"804","2018-03-14",939,1583,50,2572
"805","2018-03-15",926,1194,55,2175
"806","2018-03-16",812,1796,67,2675
"807","2018-03-17",642,1717,28,2387
"808","2018-03-18",698,1987,27,2712
"809","2018-03-19",945,1894,63,2902
"810","2018-03-20",920,1913,58,2891
"811","2018-03-21",925,1289,76,2290
"812","2018-03-22",462,1425,54,1941
"813","2018-03-23",643,1704,53,2400
"814","2018-03-24",648,1684,20,2352
"815","2018-03-25",409,2005,30,2444
"816","2018-03-26",715,1684,44,2443
"817","2018-03-27",925,1659,54,2638
"818","2018-03-28",966,1626,35,2627
"819","2018-03-29",894,1495,59,2448
"820","2018-03-30",947,1494,61,2502
"821","2018-03-31",850,1454,24,2328
"822","2018-04-01",892,1541,30,2463
"823","2018-04-02",1124,1821,62,3007
"824","2018-04-03",1141,1619,45,2805
"825","2018-04-04",1083,1516,54,2653
"826","2018-04-05",1054,1415,62,2531
"827","2018-04-06",988,1400,57,2445
"828","2018-04-07",877,1398,21,2296
"829","2018-04-08",911,1729,24,2664
"830","2018-04-09",1109,1722,51,2882
"831","2018-04-10",1036,1466,43,2545
"832","2018-04-11",1029,1554,82,2665
"833","2018-04-12",1077,1653,58,2788
"834","2018-04-13",1011,1977,53,3041
"835","2018-04-14",799,1210,26,2035
"836","2018-04-15",850,1551,49,2450
"837","2018-04-16",1032,1807,63,2902
"838","2018-04-17",1008,1683,49,2740
"839","2018-04-18",1126,1699,52,2877
"840","2018-04-19",1123,1489,56,2668
"841","2018-04-20",1021,1529,64,2614
"842","2018-04-21",828,1473,36,2337
"843","2018-04-22",826,1663,29,2518
"844","2018-04-23",1180,1777,55,3012
"845","2018-04-24",1176,1522,73,2771
"846","2018-04-25",1107,1899,80,3086
"847","2018-04-26",969,2613,55,3637
"848","2018-04-27",1039,1439,36,2514
"849","2018-04-28",800,1509,15,2324
"850","2018-04-29",807,1726,18,2551
"851","2018-04-30",1030,1574,53,2657
"852","2018-05-01",978,1267,22,2267
"853","2018-05-02",1069,1322,43,2434
"854","2018-05-03",1276,1227,55,2558
"855","2018-05-04",1174,1334,93,2601
"856","2018-05-05",780,1351,26,2157
"857","2018-05-06",762,1229,41,2032
"858","2018-05-07",915,1209,36,2160
"859","2018-05-08",1033,1491,72,2596
"860","2018-05-09",1061,902,47,2010
"861","2018-05-10",1052,1152,56,2260
"862","2018-05-11",985,1430,65,2480
"863","2018-05-12",730,943,32,1705
"864","2018-05-13",728,898,44,1670
"865","2018-05-14",980,1163,220,2363
"866","2018-05-15",1143,1263,34,2440
"867","2018-05-16",1098,1129,56,2283
"868","2018-05-17",1048,1218,55,2321
"869","2018-05-18",943,1079,67,2089
"870","2018-05-19",768,1133,15,1916
"871","2018-05-20",749,1087,32,1868
"872","2018-05-21",1070,1254,74,2398
"873","2018-05-22",825,1106,33,1964
"874","2018-05-23",1047,1265,78,2390
"875","2018-05-24",1029,1340,102,2471
"876","2018-05-25",1061,1775,70,2906
"877","2018-05-26",846,1821,42,2709
"878","2018-05-27",860,1511,16,2387
"879","2018-05-28",1095,1770,50,2915
"880","2018-05-29",1116,1492,53,2661
"881","2018-05-30",1157,1479,86,2722
"882","2018-05-31",1217,1157,81,2455
"883","2018-06-01",1003,1147,47,2197
"884","2018-06-02",802,785,30,1617
"885","2018-06-03",780,842,32,1654
"886","2018-06-04",1056,1376,174,2606
"887","2018-06-05",1069,1250,55,2374
"888","2018-06-06",887,1320,26,2233
"889","2018-06-07",1072,1243,59,2374
"890","2018-06-08",1019,1016,43,2078
"891","2018-06-09",812,911,18,1741
"892","2018-06-10",813,1176,26,2015
"893","2018-06-11",1150,1377,55,2582
"894","2018-06-12",1026,1858,67,2951
"895","2018-06-13",917,800,16,1733
"896","2018-06-14",1030,1273,47,2350
"897","2018-06-15",1076,1432,62,2570
"898","2018-06-16",847,1138,24,2009
"899","2018-06-17",873,1349,32,2254
"900","2018-06-18",1022,1409,80,2511
"901","2018-06-19",1043,1482,62,2587
"902","2018-06-20",973,1449,67,2489
"903","2018-06-21",935,1327,52,2314
"904","2018-06-22",740,1119,28,1887
"905","2018-06-23",665,1109,21,1795
"906","2018-06-24",1058,1355,14,2427
"907","2018-06-25",1106,1295,42,2443
"908","2018-06-26",1071,1209,38,2318
"909","2018-06-27",1055,1386,52,2493
"910","2018-06-28",1004,1040,55,2099
"911","2018-06-29",1001,1231,39,2271
"912","2018-06-30",832,1377,30,2239
"913","2018-07-01",911,1556,38,2505
"914","2018-07-02",1077,1715,87,2879
"915","2018-07-03",1151,1640,95,2886
"916","2018-07-04",1224,1562,131,2917
"917","2018-07-05",1126,1479,96,2701
"918","2018-07-06",1030,1533,31,2594
"919","2018-07-07",823,1353,17,2193
"920","2018-07-08",836,1380,12,2228
"921","2018-07-09",1147,1292,40,2479
"922","2018-07-10",1139,1421,52,2612
"923","2018-07-11",1074,1374,53,2501
"924","2018-07-12",1062,1456,35,2553
"925","2018-07-13",1051,1185,65,2301
"926","2018-07-14",860,1061,24,1945
"927","2018-07-15",797,1070,46,1913
"928","2018-07-16",1096,1419,59,2574
"929","2018-07-17",1114,1564,70,2748
"930","2018-07-18",1143,1574,78,2795
"931","2018-07-19",1153,1637,182,2972
"932","2018-07-20",1734,1736,94,3564
"933","2018-07-21",1205,1631,69,2905
"934","2018-07-22",2108,1771,64,3943
"935","2018-07-23",2367,2105,69,4541
"936","2018-07-24",2336,1608,47,3991
"937","2018-07-25",2512,1848,71,4431
"938","2018-07-26",2547,1588,53,4188
"939","2018-07-27",2275,1799,55,4129
"940","2018-07-28",710,2162,9,2881
"941","2018-07-29",760,1862,26,2648
"942","2018-07-30",1038,2558,46,3642
"943","2018-07-31",1043,1652,41,2736
"944","2018-08-01",969,2862,38,3869
"945","2018-08-02",534,1944,75,2553
"946","2018-08-03",574,1556,61,2191
"947","2018-08-04",754,1257,22,2033
"948","2018-08-05",726,1423,48,2197
"949","2018-08-06",1058,1227,49,2334
"950","2018-08-07",1098,1056,73,2227
"951","2018-08-08",1093,988,34,2115
"952","2018-08-09",915,1253,33,2201
"953","2018-08-10",921,1013,41,1975
"954","2018-08-11",706,1027,19,1752
"955","2018-08-12",670,1260,16,1946
"956","2018-08-13",915,1347,34,2296
"957","2018-08-14",863,1105,23,1991
"958","2018-08-15",720,1113,12,1845
"959","2018-08-16",923,1438,55,2416
"960","2018-08-17",974,1317,41,2332
"961","2018-08-18",661,1508,22,2191
"962","2018-08-19",639,1572,15,2226
"963","2018-08-20",999,1790,40,2829
"964","2018-08-21",1002,2015,49,3066
"965","2018-08-22",960,2220,61,3241
"966","2018-08-23",965,1257,48,2270
"967","2018-08-24",952,2133,26,3111
"968","2018-08-25",671,2005,21,2697
"969","2018-08-26",670,1763,28,2461
"970","2018-08-27",937,1568,51,2556
"971","2018-08-28",970,1587,64,2621
"972","2018-08-29",937,1699,43,2679
"973","2018-08-30",979,1451,49,2479
"974","2018-08-31",880,1318,32,2230
"975","2018-09-01",681,1242,18,1941
"976","2018-09-02",697,1420,23,2140
"977","2018-09-03",1001,1582,59,2642
"978","2018-09-04",896,1486,63,2445
"979","2018-09-05",495,1707,27,2229
"980","2018-09-06",726,1590,58,2374
"981","2018-09-07",931,1286,51,2268
"982","2018-09-08",681,1244,15,1940
"983","2018-09-09",690,1212,16,1918
"984","2018-09-10",1066,1382,51,2499
"985","2018-09-11",936,1463,47,2446
"986","2018-09-12",1034,1175,57,2266
"987","2018-09-13",979,1420,41,2440
"988","2018-09-14",980,1453,44,2477
"989","2018-09-15",790,1495,24,2309
"990","2018-09-16",766,1562,17,2345
"991","2018-09-17",1067,1672,29,2768
"992","2018-09-18",992,1506,41,2539
"993","2018-09-19",1049,1290,36,2375
"994","2018-09-20",966,1600,44,2610
"995","2018-09-21",960,1406,35,2401
"996","2018-09-22",731,1690,34,2455
"997","2018-09-23",580,1869,13,2462
"998","2018-09-24",552,1971,12,2535
"999","2018-09-25",605,1958,17,2580
"1000","2018-09-26",836,1574,40,2450
"1001","2018-09-27",1032,1178,78,2288
"1002","2018-09-28",999,786,42,1827
"1003","2018-09-29",783,820,10,1613
"1004","2018-09-30",1605,975,20,2600
"1005","2018-10-01",1130,1336,42,2508
"1006","2018-10-02",1063,1358,81,2502
"1007","2018-10-03",853,1407,24,2284
"1008","2018-10-04",1127,1832,48,3007
"1009","2018-10-05",1035,1762,45,2842
"1010","2018-10-06",813,1637,13,2463
"1011","2018-10-07",745,1806,22,2573
"1012","2018-10-08",1099,1945,64,3108
"1013","2018-10-09",906,1768,38,2712
"1014","2018-10-10",1102,1584,32,2718
"1015","2018-10-11",965,1565,40,2570
"1016","2018-10-12",907,1410,46,2363
"1017","2018-10-13",703,1519,15,2237
"1018","2018-10-14",734,1650,28,2412
"1019","2018-10-15",920,1614,40,2574
"1020","2018-10-16",928,1580,61,2569
"1021","2018-10-17",1038,1629,63,2730
"1022","2018-10-18",926,1637,40,2603
"1023","2018-10-19",931,1338,48,2317
"1024","2018-10-20",726,1508,35,2269
"1025","2018-10-21",754,1639,88,2481
"1026","2018-10-22",1049,2439,111,3599
"1027","2018-10-23",1059,1518,50,2627
"1028","2018-10-24",1007,1415,48,2470
"1029","2018-10-25",931,1510,70,2511
"1030","2018-10-26",897,1545,71,2513
"1031","2018-10-27",666,1702,33,2401
"1032","2018-10-28",729,1839,40,2608
"1033","2018-10-29",1004,1933,88,3025
"1034","2018-10-30",1001,1889,36,2926
"1035","2018-10-31",973,1571,61,2605
"1036","2018-11-01",963,1625,80,2668
"1037","2018-11-02",884,1441,52,2377
"1038","2018-11-03",728,1530,14,2272
"1039","2018-11-04",753,1643,13,2409
"1040","2018-11-05",1116,1791,58,2965
"1041","2018-11-06",1187,1500,41,2728
"1042","2018-11-07",1111,1431,45,2587
"1043","2018-11-08",1197,1447,44,2688
"1044","2018-11-09",1044,1453,81,2578
"1045","2018-11-10",784,1326,16,2126
"1046","2018-11-11",798,1596,23,2417
"1047","2018-11-12",1027,1606,30,2663
"1048","2018-11-13",1037,1587,33,2657
"1049","2018-11-14",959,1388,29,2376
"1050","2018-11-15",1055,1414,54,2523
"1051","2018-11-16",953,1444,32,2429
"1052","2018-11-17",722,1601,18,2341
"1053","2018-11-18",750,1699,20,2469
"1054","2018-11-19",1041,1738,48,2827
"1055","2018-11-20",1046,1890,87,3023
"1056","2018-11-21",1099,2050,40,3189
"1057","2018-11-22",1032,2329,52,3413
"1058","2018-11-23",1020,2824,49,3893
"1059","2018-11-24",758,2557,32,3347
"1060","2018-11-25",732,2153,14,2899
"1061","2018-11-26",1046,2370,29,3445
"1062","2018-11-27",1013,2005,61,3079
"1063","2018-11-28",1051,1628,22,2701
"1064","2018-11-29",971,1705,60,2736
"1065","2018-11-30",1053,1736,34,2823
"1066","2018-12-01",742,1575,18,2335
"1067","2018-12-02",789,1519,29,2337
"1068","2018-12-03",1118,1993,74,3185
"1069","2018-12-04",1121,1645,50,2816
"1070","2018-12-05",1069,1641,63,2773
"1071","2018-12-06",1074,1962,65,3101
"1072","2018-12-07",909,1709,43,2661
"1073","2018-12-08",743,1720,13,2476
"1074","2018-12-09",655,1756,19,2430
"1075","2018-12-10",1021,1865,62,2948
"1076","2018-12-11",972,1747,46,2765
"1077","2018-12-12",963,1575,29,2567
"1078","2018-12-13",918,1445,58,2421
"1079","2018-12-14",941,1587,42,2570
"1080","2018-12-15",713,1162,19,1894
"1081","2018-12-16",815,1634,50,2499
"1082","2018-12-17",883,1898,80,2861
"1083","2018-12-18",958,1815,75,2848
"1084","2018-12-19",942,1620,58,2620
"1085","2018-12-20",875,1518,54,2447
"1086","2018-12-21",815,1457,61,2333
"1087","2018-12-22",615,1471,26,2112
"1088","2018-12-23",672,1765,26,2463
"1089","2018-12-24",791,1593,63,2447
"1090","2018-12-25",565,1299,34,1898
"1091","2018-12-26",922,1661,33,2616
"1092","2018-12-27",893,1670,46,2609
"1093","2018-12-28",870,1547,18,2435
"1094","2018-12-29",700,1280,8,1988
"1095","2018-12-30",696,1314,16,2026
"1096","2018-12-31",965,1441,38,2444
"1097","2019-01-01",782,1735,34,2551
"1098","2019-01-02",977,2049,47,3073
"1099","2019-01-03",989,2047,44,3080
"1100","2019-01-04",978,2145,38,3161
"1101","2019-01-05",759,1934,10,2703
"1102","2019-01-06",704,1487,21,2212
"1103","2019-01-07",997,1746,56,2799
"1104","2019-01-08",1067,2269,47,3383
"1105","2019-01-09",1051,1926,56,3033
"1106","2019-01-10",1129,1738,71,2938
"1107","2019-01-11",991,1969,34,2994
"1108","2019-01-12",802,1765,48,2615
"1109","2019-01-13",767,1784,39,2590
"1110","2019-01-14",1060,1946,36,3042
"1111","2019-01-15",1100,1709,60,2869
"1112","2019-01-16",1102,1478,31,2611
"1113","2019-01-17",1013,2080,37,3130
"1114","2019-01-18",1092,2046,61,3199
"1115","2019-01-19",814,1916,38,2768
"1116","2019-01-20",758,1722,19,2499
"1117","2019-01-21",1033,2117,82,3232
"1118","2019-01-22",1136,1987,71,3194
"1119","2019-01-23",996,3215,39,4250
"1120","2019-01-24",1023,2579,50,3652
"1121","2019-01-25",933,2077,41,3051
"1122","2019-01-26",739,1848,22,2609
"1123","2019-01-27",745,2050,17,2812
"1124","2019-01-28",970,1968,26,2964
"1125","2019-01-29",1037,1903,59,2999
"1126","2019-01-30",1012,1838,53,2903
"1127","2019-01-31",978,1545,37,2560
"1128","2019-02-01",892,1862,38,2792
"1129","2019-02-02",736,2083,34,2853
"1130","2019-02-03",647,2009,21,2677
"1131","2019-02-04",585,2652,27,3264
"1132","2019-02-05",419,2074,30,2523
"1133","2019-02-06",602,1926,38,2566
"1134","2019-02-07",938,2187,61,3186
"1135","2019-02-08",958,2103,41,3102
"1136","2019-02-09",738,1920,18,2676
"1137","2019-02-10",775,2380,18,3173
"1138","2019-02-11",1036,2176,37,3249
"1139","2019-02-12",1052,2283,68,3403
"1140","2019-02-13",1093,2403,48,3544
"1141","2019-02-14",1029,2045,78,3152
"1142","2019-02-15",972,2068,64,3104
"1143","2019-02-16",758,2064,17,2839
"1144","2019-02-17",803,2165,31,2999
"1145","2019-02-18",1048,2089,59,3196
"1146","2019-02-19",1050,2064,35,3149
"1147","2019-02-20",1103,2041,93,3237
"1148","2019-02-21",1001,2164,54,3219
"1149","2019-02-22",967,1943,84,2994
"1150","2019-02-23",776,2447,30,3253
"1151","2019-02-24",850,2419,74,3343
"1152","2019-02-25",1047,2448,119,3614
"1153","2019-02-26",996,2109,39,3144
"1154","2019-02-27",1009,1586,54,2649
"1155","2019-02-28",1103,1756,37,2896
"1156","2019-03-01",798,2200,12,3010
"1157","2019-03-02",826,2291,17,3134
"1158","2019-03-03",819,2511,16,3346
"1159","2019-03-04",1026,2262,56,3344
"1160","2019-03-05",1040,1801,52,2893
"1161","2019-03-06",1048,1860,53,2961
"1162","2019-03-07",974,1593,72,2639
"1163","2019-03-08",897,1676,74,2647
"1164","2019-03-09",799,1598,49,2446
"1165","2019-03-10",771,1944,59,2774
"1166","2019-03-11",1064,1871,64,2999
"1167","2019-03-12",1046,1886,72,3004
"1168","2019-03-13",977,1720,51,2748
"1169","2019-03-14",966,1654,41,2661
"1170","2019-03-15",980,1801,34,2815
"1171","2019-03-16",744,1719,14,2477
"1172","2019-03-17",806,1788,30,2624
"1173","2019-03-18",1085,1917,40,3042
"1174","2019-03-19",1111,1771,38,2920
"1175","2019-03-20",1019,1700,52,2771
"1176","2019-03-21",985,1611,72,2668
"1177","2019-03-22",975,1670,38,2683
"1178","2019-03-23",829,2037,15,2881
"1179","2019-03-24",833,2088,20,2941
"1180","2019-03-25",1055,1865,45,2965
"1181","2019-03-26",1054,1882,60,2996
"1182","2019-03-27",1046,1625,57,2728
"1183","2019-03-28",1102,1599,52,2753
"1184","2019-03-29",926,1597,47,2570
"1185","2019-03-30",758,1728,25,2511
"1186","2019-03-31",734,1790,18,2542
"1187","2019-04-01",995,1338,84,2417
"1188","2019-04-02",985,1592,99,2676
"1189","2019-04-03",1031,1652,51,2734
"1190","2019-04-04",1013,1675,40,2728
"1191","2019-04-05",934,1505,46,2485
"1192","2019-04-06",729,1799,24,2552
"1193","2019-04-07",746,1709,17,2472
"1194","2019-04-08",1006,1602,45,2653
"1195","2019-04-09",1033,1679,63,2775
"1196","2019-04-10",1138,1683,42,2863
"1197","2019-04-11",1046,1643,73,2762
"1198","2019-04-12",952,1492,34,2478
"1199","2019-04-13",734,1629,12,2375
"1200","2019-04-14",761,1419,18,2198
"1201","2019-04-15",1023,1762,28,2813
"1202","2019-04-16",1013,1566,54,2633
"1203","2019-04-17",990,1686,76,2752
"1204","2019-04-18",1019,1550,69,2638
"1205","2019-04-19",959,1661,44,2664
"1206","2019-04-20",751,1620,9,2380
"1207","2019-04-21",787,1610,15,2412
"1208","2019-04-22",1074,1689,64,2827
"1209","2019-04-23",1016,1550,62,2628
"1210","2019-04-24",1010,1364,50,2424
"1211","2019-04-25",1026,1330,23,2379
"1212","2019-04-26",835,1295,28,2158
"1213","2019-04-27",787,1377,7,2171
"1214","2019-04-28",783,1377,22,2182
"1215","2019-04-29",1035,1561,42,2638
"1216","2019-04-30",1073,1654,51,2778
